Log-time,Sensor-1,Sensor-2,Sensor-3,Sensor-4,Sensor-5,Sum-value
2023-03-06 12:21:30.535397,19,15,6,9,14,63
2023-03-06 12:21:31.947581,10,23,20,4,19,76
2023-03-06 12:21:33.450604,15,14,8,10,16,63
2023-03-06 12:21:34.948884,5,2,21,2,5,35
2023-03-06 12:21:36.451494,4,8,9,12,3,36
2023-03-06 12:21:37.950927,7,13,8,9,11,48
2023-03-06 12:21:39.454374,23,17,9,8,6,63
2023-03-06 12:21:40.953839,16,7,11,6,4,44
2023-03-06 12:21:42.456839,18,12,16,5,21,72
2023-03-06 12:21:43.959887,16,23,23,5,23,90
2023-03-06 12:21:45.459193,6,14,12,18,13,63
2023-03-06 12:21:46.961111,14,16,24,18,22,94
2023-03-06 12:21:48.465296,18,16,4,6,14,58
2023-03-06 12:21:49.963675,4,18,12,4,17,55
2023-03-06 12:21:51.467158,19,7,7,14,6,53
2023-03-06 12:21:52.965842,14,5,6,5,3,33
2023-03-06 12:21:54.465409,21,13,4,17,22,77
2023-03-06 12:21:55.968463,16,10,5,2,13,46
2023-03-06 12:21:57.470532,16,11,14,13,23,77
2023-03-06 12:21:58.974222,24,11,7,5,9,56
2023-03-06 12:22:00.477400,15,15,3,11,5,49
2023-03-06 12:22:01.971662,18,10,6,9,15,58
2023-03-06 12:22:03.475060,14,12,13,3,11,53
2023-03-06 12:22:04.977935,21,14,6,20,2,63
2023-03-06 12:22:06.478120,13,19,9,9,13,63
2023-03-06 12:22:07.981821,4,7,24,19,18,72
2023-03-06 12:22:09.484493,21,11,8,9,21,70
2023-03-06 12:22:10.983094,13,16,13,7,13,62
2023-03-06 12:22:12.486662,20,12,19,16,8,75
2023-03-06 12:22:13.985269,21,15,15,18,19,88
2023-03-06 12:22:15.488169,20,4,24,21,8,77
2023-03-06 12:22:16.986926,5,4,17,19,13,58
2023-03-06 12:22:18.490147,2,15,24,22,6,69
2023-03-06 12:22:19.989497,13,20,3,3,2,41
2023-03-06 12:22:21.492445,22,17,7,24,17,87
2023-03-06 12:22:22.995912,14,4,23,3,12,56
2023-03-06 12:22:24.495399,23,15,7,8,14,67
2023-03-06 12:22:25.998491,2,18,2,5,14,41
2023-03-06 12:22:27.497556,17,10,12,23,15,77
2023-03-06 12:22:29.000645,4,20,12,17,4,57
2023-03-06 12:22:30.499293,12,7,8,23,15,65
2023-03-06 12:22:32.002523,11,18,10,10,4,53
2023-03-06 12:22:33.501127,22,21,12,20,7,82
2023-03-06 12:22:35.004364,21,13,18,14,22,88
2023-03-06 12:22:36.507841,7,14,21,7,17,66
2023-03-06 12:22:38.006571,15,9,21,4,15,64
2023-03-06 12:22:39.509678,18,10,6,15,5,54
2023-03-06 12:22:41.009001,2,7,9,16,22,56
2023-03-06 12:22:42.512490,15,24,19,14,18,90
2023-03-06 12:22:44.015158,18,7,8,10,12,55
2023-03-06 12:22:45.515028,12,7,17,17,18,71
2023-03-06 12:22:47.013515,19,13,17,15,21,85
2023-03-06 12:22:48.517005,6,24,12,24,20,86
2023-03-06 12:22:50.020124,2,20,2,20,7,51
2023-03-06 12:22:51.519488,8,19,16,2,14,59
2023-03-06 12:22:53.022696,24,17,21,5,19,86
2023-03-06 12:22:54.521190,18,5,23,22,11,79
2023-03-06 12:22:56.024132,5,7,7,5,10,34
2023-03-06 12:22:57.524007,21,14,20,19,2,76
2023-03-06 12:22:59.027004,14,15,4,15,20,68
2023-03-06 12:56:20.649044,19,15,6,9,14,63
2023-03-06 12:56:22.066330,10,23,20,4,19,76
2023-03-06 12:56:23.562572,15,14,8,10,16,63
2023-03-06 12:56:25.065547,5,2,21,2,5,35
2023-03-06 12:56:26.564909,4,8,9,12,3,36
2023-03-06 12:56:28.067890,7,13,8,9,11,48
2023-03-06 12:56:29.567206,23,17,9,8,6,63
2023-03-06 12:56:31.070193,16,7,11,6,4,44
2023-03-06 12:56:32.573585,18,12,16,5,21,72
2023-03-06 12:56:34.071858,16,23,23,5,23,90
2023-03-06 12:56:35.574924,6,14,12,18,13,63
2023-03-06 12:56:37.074780,14,16,24,18,22,94
2023-03-06 12:56:38.577883,18,16,4,6,14,58
2023-03-06 12:56:40.081159,4,18,12,4,17,55
2023-03-06 12:56:41.579424,19,7,7,14,6,53
2023-03-06 12:56:43.078655,14,5,6,5,3,33
2023-03-06 12:56:44.582051,21,13,4,17,22,77
2023-03-06 12:56:46.085328,16,10,5,2,13,46
2023-03-06 12:56:47.585020,16,11,14,13,23,77
2023-03-06 12:56:49.087246,24,11,7,5,9,56
2023-03-06 12:56:50.586979,15,15,3,11,5,49
2023-03-06 12:56:52.089331,18,10,6,9,15,58
2023-03-06 12:56:53.592680,14,12,13,3,11,53
2023-03-06 12:56:55.092106,21,14,6,20,2,63
2023-03-06 12:56:56.591459,13,19,9,9,13,63
2023-03-06 12:56:58.094870,4,7,24,19,18,72
2023-03-06 12:56:59.597098,21,11,8,9,21,70
2023-03-06 12:57:01.100171,13,16,13,7,13,62
2023-03-06 12:57:02.600052,20,12,19,16,8,75
2023-03-06 12:57:04.098776,21,15,15,18,19,88
2023-03-06 12:57:05.601751,20,4,24,21,8,77
2023-03-06 12:57:07.104818,5,4,17,19,13,58
2023-03-06 12:57:08.608161,2,15,24,22,6,69
2023-03-06 12:57:10.107061,13,20,3,3,2,41
2023-03-06 12:57:11.606664,22,17,7,24,17,87
2023-03-06 12:57:13.109768,14,4,23,3,12,56
2023-03-06 12:57:14.612609,23,15,7,8,14,67
2023-03-07 15:33:21.332093,19,15,6,9,14,63
2023-03-07 15:33:22.744454,10,23,20,4,19,76
2023-03-07 15:33:24.247781,15,14,8,10,16,63
2023-03-07 15:33:25.747045,5,2,21,2,5,35
2023-03-07 15:33:27.246895,4,8,9,12,3,36
2023-03-07 15:33:28.755404,7,13,8,9,11,48
2023-03-07 15:33:30.253581,23,17,9,8,6,63
2023-03-07 15:33:31.753301,16,7,11,6,4,44
2023-03-07 15:33:33.256512,18,12,16,5,21,72
2023-03-07 15:33:34.759831,16,23,23,5,23,90
2023-03-07 15:33:36.258008,6,14,12,18,13,63
2023-03-07 15:33:37.758098,14,16,24,18,22,94
2023-03-07 15:33:39.261723,18,16,4,6,14,58
2023-03-07 15:33:40.765303,4,18,12,4,17,55
2023-03-07 15:33:42.264001,19,7,7,14,6,53
2023-03-07 15:33:43.763855,14,5,6,5,3,33
2023-03-07 15:33:45.267014,21,13,4,17,22,77
2023-03-07 15:33:46.770566,16,10,5,2,13,46
2023-03-07 15:33:48.270040,16,11,14,13,23,77
2023-03-07 15:33:49.772527,24,11,7,5,9,56
2023-03-07 15:33:51.272654,15,15,3,11,5,49
2023-03-07 15:33:52.775820,18,10,6,9,15,58
2023-03-07 15:33:54.275787,14,12,13,3,11,53
2023-03-07 15:33:55.777827,21,14,6,20,2,63
2023-03-07 15:33:57.277638,13,19,9,9,13,63
2023-03-07 15:33:58.781039,4,7,24,19,18,72
2023-03-07 15:34:00.284233,21,11,8,9,21,70
2023-03-07 15:34:01.782850,13,16,13,7,13,62
2023-03-07 15:34:03.286531,20,12,19,16,8,75
2023-03-07 15:34:04.785485,21,15,15,18,19,88
2023-03-07 15:34:06.289035,20,4,24,21,8,77
2023-03-07 15:34:07.788946,5,4,17,19,13,58
2023-03-07 15:34:09.292233,2,15,24,22,6,69
2023-03-07 15:34:10.791771,13,20,3,3,2,41
2023-03-07 15:34:12.295064,22,17,7,24,17,87
2023-03-07 15:34:13.793557,14,4,23,3,12,56
2023-03-07 15:34:15.296705,23,15,7,8,14,67
2023-03-07 15:34:16.800756,2,18,2,5,14,41
2023-03-07 15:34:18.300313,17,10,12,23,15,77
2023-03-07 15:34:19.802457,4,20,12,17,4,57
2023-03-07 15:34:21.302737,12,7,8,23,15,65
2023-03-07 15:57:46.010255,19,15,6,9,14,63
2023-03-07 15:57:47.038311,10,23,20,4,19,76
2023-03-07 15:57:48.062808,15,14,8,10,16,63
2023-03-07 15:57:49.090863,5,2,21,2,5,35
2023-03-07 15:57:50.114322,4,8,9,12,3,36
2023-03-07 15:57:51.138179,7,13,8,9,11,48
2023-03-07 15:57:52.166411,23,17,9,8,6,63
2023-03-07 15:57:53.190405,16,7,11,6,4,44
2023-03-07 15:57:54.214266,18,12,16,5,21,72
2023-03-07 15:57:55.241496,16,23,23,5,23,90
2023-03-07 15:57:56.269117,6,14,12,18,13,63
2023-03-07 15:57:57.301543,14,16,24,18,22,94
2023-03-07 15:57:58.328732,18,16,4,6,14,58
2023-03-07 15:57:59.352656,4,18,12,4,17,55
2023-03-07 15:58:00.376123,19,7,7,14,6,53
2023-03-07 15:58:01.401373,14,5,6,5,3,33
2023-03-07 15:58:02.428935,21,13,4,17,22,77
2023-03-07 15:58:03.455837,16,10,5,2,13,46
2023-03-07 15:58:04.480309,16,11,14,13,23,77
2023-03-07 15:58:05.508497,24,11,7,5,9,56
2023-03-07 15:58:06.532814,15,15,3,11,5,49
2023-03-07 15:58:07.560524,18,10,6,9,15,58
2023-03-07 15:58:08.587564,14,12,13,3,11,53
2023-03-07 15:58:09.616455,21,14,6,20,2,63
2023-03-07 15:58:10.640495,13,19,9,9,13,63
2023-03-07 15:58:11.667433,4,7,24,19,18,72
2023-03-07 15:58:12.691466,21,11,8,9,21,70
2023-03-07 15:58:13.715072,13,16,13,7,13,62
2023-03-07 15:58:14.743654,20,12,19,16,8,75
2023-03-07 15:58:15.771438,21,15,15,18,19,88
2023-03-07 15:58:16.799105,20,4,24,21,8,77
2023-03-07 15:58:17.826627,5,4,17,19,13,58
2023-03-07 15:58:18.850554,2,15,24,22,6,69
2023-03-07 15:58:19.875466,13,20,3,3,2,41
2023-03-07 15:58:20.899128,22,17,7,24,17,87
2023-03-07 15:58:21.926531,14,4,23,3,12,56
2023-03-07 15:58:22.954217,23,15,7,8,14,67
2023-03-07 15:58:23.978967,2,18,2,5,14,41
2023-03-07 15:58:25.002370,17,10,12,23,15,77
2023-03-07 15:58:26.029892,4,20,12,17,4,57
2023-03-07 15:58:27.054119,12,7,8,23,15,65
2023-03-07 15:58:28.077809,11,18,10,10,4,53
2023-03-07 15:58:29.105212,22,21,12,20,7,82
2023-03-07 15:58:30.130524,21,13,18,14,22,88
2023-03-07 15:58:31.157800,7,14,21,7,17,66
2023-03-07 15:58:32.185364,15,9,21,4,15,64
2023-03-07 15:58:33.209672,18,10,6,15,5,54
2023-03-07 15:58:34.233228,2,7,9,16,22,56
2023-03-07 15:58:35.258160,15,24,19,14,18,90
2023-03-07 15:58:36.285714,18,7,8,10,12,55
2023-03-07 15:58:37.312836,12,7,17,17,18,71
2023-03-07 15:58:38.340511,19,13,17,15,21,85
2023-03-07 15:58:39.369579,6,24,12,24,20,86
2023-03-07 15:58:40.397559,2,20,2,20,7,51
2023-03-07 15:58:41.421378,8,19,16,2,14,59
2023-03-07 15:58:42.448671,24,17,21,5,19,86
2023-03-07 15:58:43.472866,18,5,23,22,11,79
2023-03-07 15:58:44.501410,5,7,7,5,10,34
2023-03-07 15:58:45.525228,21,14,20,19,2,76
2023-03-07 15:58:46.552639,14,15,4,15,20,68
2023-03-07 15:58:47.580464,16,17,7,16,2,58
2023-03-07 15:58:48.604560,23,22,12,21,4,82
2023-03-07 15:58:49.632934,15,14,18,5,24,76
2023-03-07 15:58:50.660485,23,3,5,15,15,61
2023-03-07 15:58:51.684435,20,2,17,4,23,66
2023-03-07 15:58:52.711996,6,22,15,23,18,84
2023-03-07 15:58:53.739842,18,6,10,3,5,42
2023-03-07 15:58:54.764459,14,23,4,16,13,70
2023-03-07 15:58:55.792607,14,14,7,4,14,53
2023-03-07 15:58:56.820020,16,16,9,6,6,53
2023-03-07 15:58:57.844144,20,24,24,7,4,79
2023-03-07 15:58:58.871098,5,22,14,20,6,67
2023-03-07 15:58:59.896880,24,13,15,22,17,91
2023-03-07 15:59:00.924445,22,9,8,4,6,49
2023-03-07 15:59:01.947978,13,13,5,20,17,68
2023-03-07 15:59:02.975267,23,18,19,10,4,74
2023-03-07 15:59:03.998950,6,10,6,22,12,56
2023-03-07 15:59:05.023342,24,21,24,9,14,92
2023-03-07 15:59:06.051762,17,12,10,10,22,71
2023-03-07 15:59:07.084903,8,4,10,9,8,39
2023-03-07 15:59:08.107178,24,23,9,10,11,77
2023-03-07 15:59:09.132368,16,12,9,13,11,61
2023-03-07 15:59:10.159684,11,14,19,9,11,64
2023-03-07 15:59:11.187373,10,24,7,8,4,53
2023-03-07 15:59:12.211202,8,17,12,6,6,49
2023-03-07 15:59:13.234750,17,24,18,24,19,102
2023-03-07 15:59:14.263841,18,5,7,23,22,75
2023-03-07 15:59:15.291110,3,22,14,18,13,70
2023-03-07 15:59:16.318806,7,18,3,20,24,72
2023-03-07 15:59:17.342624,8,3,12,15,5,43
2023-03-07 15:59:18.366485,14,22,20,14,7,77
2023-03-07 15:59:19.395448,20,10,10,16,12,68
2023-03-07 15:59:20.423268,6,14,7,7,20,54
2023-03-07 15:59:21.447093,16,13,4,24,11,68
2023-03-07 15:59:22.474548,2,20,21,22,24,89
2023-03-07 15:59:23.502111,13,4,6,12,9,44
2023-03-07 15:59:24.527310,24,19,8,6,13,70
2023-03-07 15:59:25.554755,13,3,5,9,8,38
2023-03-07 15:59:26.578577,12,22,11,22,10,77
2023-03-07 15:59:27.606152,23,18,12,16,23,92
2023-03-07 15:59:28.633681,6,5,3,12,18,44
2023-03-07 15:59:29.658630,24,6,8,19,17,74
2023-03-07 15:59:30.682742,11,10,4,15,18,58
2023-03-07 15:59:31.710195,8,2,14,13,20,57
2023-03-07 15:59:32.734273,7,7,24,21,10,69
2023-03-07 15:59:33.757847,9,24,10,19,12,74
2023-03-07 15:59:34.785301,19,10,21,6,18,74
2023-03-07 15:59:35.810623,16,21,4,4,12,57
2023-03-07 15:59:36.837945,16,21,23,19,3,82
2023-03-07 15:59:37.865765,3,9,7,14,12,45
2023-03-07 15:59:38.889587,6,12,17,20,10,65
2023-03-07 15:59:39.917161,9,10,21,12,20,72
2023-03-07 15:59:40.945824,21,15,11,20,16,83
2023-03-07 15:59:41.973598,22,10,18,22,9,81
2023-03-07 15:59:43.001228,19,5,12,5,14,55
2023-03-07 15:59:44.025467,2,7,3,22,15,49
2023-03-07 15:59:45.050289,22,16,22,9,20,89
2023-03-07 15:59:46.077988,4,23,23,2,20,72
2023-03-07 15:59:47.105448,6,23,24,20,10,83
2023-03-07 15:59:48.129513,19,9,3,8,2,41
2023-03-07 15:59:49.152966,19,23,7,18,7,74
2023-03-07 15:59:50.176788,8,8,17,12,2,47
2023-03-07 15:59:51.201615,2,18,19,11,10,60
2023-03-07 15:59:52.229192,5,21,2,7,12,47
2023-03-07 15:59:53.253156,6,17,17,24,8,72
2023-03-07 15:59:54.276537,19,5,13,21,14,72
2023-03-07 15:59:55.300370,19,19,10,17,19,84
2023-03-07 15:59:56.329245,11,3,10,10,12,46
2023-03-07 15:59:57.357068,12,16,21,3,24,76
2023-03-07 15:59:58.384646,15,13,17,8,23,76
2023-03-07 15:59:59.408680,3,22,24,8,2,59
2023-03-07 16:00:00.432169,3,5,20,15,9,52
2023-03-07 16:00:01.456010,14,11,9,23,15,72
2023-03-07 16:00:02.481231,10,16,21,10,19,76
2023-03-07 16:00:03.508791,17,17,9,13,3,59
2023-03-07 16:00:04.532619,12,9,6,19,24,70
2023-03-07 16:00:05.556187,22,2,18,4,22,68
2023-03-07 16:00:06.579583,9,7,7,17,14,54
2023-03-07 16:00:07.603191,13,22,7,11,6,59
2023-03-07 16:00:08.628255,18,9,2,21,6,56
2023-03-07 16:00:09.652249,6,17,17,6,18,64
2023-03-07 16:00:10.676072,9,20,23,14,18,84
2023-03-07 16:00:11.703532,6,13,19,3,18,59
2023-03-07 16:00:12.731089,6,12,8,10,6,42
2023-03-07 16:00:13.756173,10,24,16,15,15,80
2023-03-07 16:00:14.784010,11,5,9,13,9,47
2023-03-07 16:00:15.807710,14,5,15,7,12,53
2023-03-07 16:00:16.835024,16,9,5,7,3,40
2023-03-07 16:00:17.858862,23,22,16,15,11,87
2023-03-07 16:00:18.887942,18,14,4,24,20,80
2023-03-07 16:00:19.915202,22,11,4,16,19,72
2023-03-07 16:00:20.942911,17,9,12,8,23,69
2023-03-07 16:00:21.967177,2,7,7,10,5,31
2023-03-07 16:00:22.990599,3,21,21,2,8,55
2023-03-07 16:00:24.014281,24,7,15,15,21,82
2023-03-07 16:00:25.043282,2,7,20,10,19,58
2023-03-07 16:00:26.067229,18,7,17,7,13,62
2023-03-07 16:00:27.094532,23,4,20,19,13,79
2023-03-07 16:00:28.118652,15,4,23,4,23,69
2023-03-07 16:00:29.142201,6,10,12,13,16,57
2023-03-07 16:00:30.171040,20,14,3,18,7,62
2023-03-07 16:00:31.195119,24,5,13,21,16,79
2023-03-07 16:00:32.222138,12,21,15,17,3,68
2023-03-07 16:00:33.249838,14,13,5,18,17,67
2023-03-07 16:00:34.273783,2,17,10,22,14,65
2023-03-07 16:00:35.299066,16,14,18,21,16,85
2023-03-07 16:00:36.327875,23,3,22,5,20,73
2023-03-07 16:00:37.354206,24,22,19,12,15,92
2023-03-07 16:00:38.381885,12,16,18,10,23,79
2023-03-07 16:00:39.410983,16,20,3,9,2,50
2023-03-07 16:00:40.434798,9,6,3,16,11,45
2023-03-07 16:00:41.458529,18,10,6,5,13,52
2023-03-07 16:00:42.485955,18,14,16,21,23,92
2023-03-07 16:00:43.513794,15,10,22,13,8,68
2023-03-07 16:00:44.542606,14,17,11,16,6,64
2023-03-07 16:00:45.570008,3,13,17,9,17,59
2023-03-07 16:00:46.593968,22,3,5,4,2,36
2023-03-07 16:00:47.617869,14,5,20,2,6,47
2023-03-07 16:00:48.641811,21,10,14,22,24,91
2023-03-07 16:00:49.669260,13,6,22,12,18,71
2023-03-07 16:00:50.694578,4,12,4,10,15,45
2023-03-07 16:00:51.721656,16,3,7,23,2,51
2023-03-07 16:00:52.745471,15,11,9,19,11,65
2023-03-07 16:00:53.773199,6,24,7,21,18,76
2023-03-07 16:00:54.797149,5,11,6,7,10,39
2023-03-07 16:00:55.821823,11,11,18,18,13,71
2023-03-07 16:00:56.849533,15,10,16,10,14,65
2023-03-07 16:00:57.877141,10,19,17,24,12,82
2023-03-07 16:00:58.904644,16,20,21,2,9,68
2023-03-07 16:00:59.928617,20,17,5,5,11,58
2023-03-07 16:01:00.953989,6,18,4,20,17,65
2023-03-07 16:01:01.981304,13,20,4,9,8,54
2023-03-07 16:01:03.005260,3,3,20,17,9,52
2023-03-07 16:01:04.028979,13,3,18,23,20,77
2023-03-07 16:01:05.056414,7,3,17,16,15,58
2023-03-07 16:01:06.080393,12,5,17,7,2,43
2023-03-07 16:01:07.105329,17,5,4,24,19,69
2023-03-07 16:01:08.132765,23,12,13,13,19,80
2023-03-07 16:01:09.160614,9,11,2,8,5,35
2023-03-07 16:01:10.184302,21,2,4,4,14,45
2023-03-07 16:01:11.207832,11,4,8,2,21,46
2023-03-07 16:01:12.232679,8,18,16,2,5,49
2023-03-07 16:01:13.256781,8,9,8,2,19,46
2023-03-07 16:01:14.280379,9,20,9,6,20,64
2023-03-07 16:01:15.304329,17,16,14,6,21,74
2023-03-07 16:01:16.331512,8,23,12,13,5,61
2023-03-07 16:01:17.355629,5,3,6,19,14,47
2023-03-07 16:01:18.380325,2,5,20,24,8,59
2023-03-07 16:01:19.404271,12,20,23,17,23,95
2023-03-07 16:01:20.431718,14,17,17,18,2,68
2023-03-07 16:01:21.459269,11,14,8,18,13,64
2023-03-07 16:01:22.488237,18,23,16,19,9,85
2023-03-07 16:01:23.515639,6,4,6,5,19,40
2023-03-07 16:01:24.539348,8,7,7,9,21,52
2023-03-07 16:01:25.563043,5,4,17,22,8,56
2023-03-07 16:01:26.587181,16,13,8,16,10,63
2023-03-07 16:01:27.611035,3,10,8,18,5,44
2023-03-07 16:01:28.635690,19,24,18,7,17,85
2023-03-07 16:01:29.663526,24,4,17,23,18,86
2023-03-07 16:01:30.691119,5,9,12,13,19,58
2023-03-07 16:01:31.715076,13,4,2,21,24,64
2023-03-07 16:01:32.738773,9,9,21,22,22,83
2023-03-07 16:01:33.762343,23,2,18,20,9,72
2023-03-07 16:01:34.787560,24,21,11,7,9,72
2023-03-07 16:01:35.811134,10,21,14,2,13,60
2023-03-07 16:01:36.838294,6,9,24,22,8,69
2023-03-07 16:01:37.862112,21,5,13,6,23,68
2023-03-07 16:01:38.886110,20,22,23,2,6,73
2023-03-07 16:01:39.909811,18,3,2,9,2,34
2023-03-07 16:01:40.934496,10,13,10,8,17,58
2023-03-07 16:01:41.962215,18,22,19,11,6,76
2023-03-07 16:01:42.986338,11,18,15,9,16,69
2023-03-07 16:01:44.013885,2,13,20,5,5,45
2023-03-07 16:01:45.037433,24,16,6,9,18,73
2023-03-07 16:01:46.062529,20,18,11,7,24,80
2023-03-07 16:01:47.089969,21,24,22,12,10,89
2023-03-07 16:01:48.117940,23,9,7,24,21,84
2023-03-07 16:01:49.141499,6,20,6,12,3,47
2023-03-07 16:01:50.165051,10,11,19,16,8,64
2023-03-07 16:01:51.193868,3,21,24,13,21,82
2023-03-07 16:01:52.221627,3,7,3,15,14,42
2023-03-07 16:01:53.245706,11,14,24,6,8,63
2023-03-07 16:01:54.269405,16,8,5,17,22,68
2023-03-07 16:01:55.296869,19,21,15,11,9,75
2023-03-07 16:01:56.325800,16,9,2,10,21,58
2023-03-07 16:01:57.353368,4,15,17,2,15,53
2023-03-07 16:01:58.381071,11,7,24,4,18,64
2023-03-07 16:01:59.405042,23,6,7,23,7,66
2023-03-07 16:02:00.428747,20,15,12,7,21,75
2023-03-07 16:02:01.453968,6,23,9,20,15,73
2023-03-07 16:02:02.477231,8,11,22,14,21,76
2023-03-07 16:02:03.500930,3,4,18,21,19,65
2023-03-07 16:02:04.524933,15,10,15,19,10,69
2023-03-07 16:02:05.552362,13,13,19,16,5,66
2023-03-07 16:02:06.576337,8,21,24,9,19,81
2023-03-07 16:02:07.601188,16,23,14,3,11,67
2023-03-07 16:02:08.628556,12,23,11,7,2,55
2023-03-07 16:02:09.652569,23,11,8,16,4,62
2023-03-07 16:02:10.676399,15,10,14,3,22,64
2023-03-07 16:02:11.700101,4,21,5,24,8,62
2023-03-07 16:02:12.723555,19,2,22,14,11,68
2023-03-07 16:02:13.748769,3,19,12,12,23,69
2023-03-07 16:02:14.775920,6,13,23,24,12,78
2023-03-07 16:02:15.803617,24,9,11,11,4,59
2023-03-07 16:02:16.827313,24,7,19,21,19,90
2023-03-07 16:02:17.851568,23,10,24,11,20,88
2023-03-07 16:02:18.880273,16,15,5,18,3,57
2023-03-07 16:02:19.904239,13,8,23,8,10,62
2023-03-07 16:02:20.927930,12,5,18,12,3,50
2023-03-07 16:02:21.951629,14,22,22,19,21,98
2023-03-07 16:02:22.979083,8,16,10,17,2,53
2023-03-07 16:02:24.003036,18,10,6,13,21,68
2023-03-07 16:02:25.027987,6,6,17,17,8,54
2023-03-07 16:02:26.051700,17,21,20,22,10,90
2023-03-07 16:02:27.079275,22,5,7,24,4,62
2023-03-07 16:02:28.102679,13,14,3,24,21,75
2023-03-07 16:02:29.130261,9,4,15,24,19,71
2023-03-07 16:02:30.155631,9,7,20,5,7,48
2023-03-07 16:02:31.179332,14,8,20,10,19,71
2023-03-07 16:02:32.206768,4,13,10,10,7,44
2023-03-07 16:02:33.234483,5,13,12,11,15,56
2023-03-07 16:02:34.262188,4,15,3,4,21,47
2023-03-07 16:02:35.287393,10,5,11,10,6,42
2023-03-07 16:02:36.314971,20,22,4,18,6,70
2023-03-07 16:02:37.342558,3,16,13,17,15,64
2023-03-07 16:02:38.370251,13,13,16,8,8,58
2023-03-07 16:02:39.394206,13,23,7,23,10,76
2023-03-07 16:02:40.418998,11,24,13,5,21,74
2023-03-07 16:02:41.446439,10,15,5,17,4,51
2023-03-07 16:02:42.470269,24,9,2,12,20,67
2023-03-07 16:02:43.494277,3,7,18,11,9,48
2023-03-07 16:02:44.517841,19,16,5,20,21,81
2023-03-07 16:02:45.541794,17,24,8,9,11,69
2023-03-07 16:02:46.566622,2,19,6,22,5,54
2023-03-07 16:02:47.590326,24,9,16,3,10,62
2023-03-07 16:02:48.614156,18,10,4,17,22,71
2023-03-07 16:02:49.641492,12,16,19,6,6,59
2023-03-07 16:02:50.665435,9,21,12,15,19,76
2023-03-07 16:02:51.689263,4,2,24,7,12,49
2023-03-07 16:02:52.713965,2,12,13,3,11,41
2023-03-07 16:02:53.737499,7,9,13,20,19,68
2023-03-07 16:02:54.761327,15,17,10,17,12,71
2023-03-07 16:02:55.788963,20,24,16,19,7,86
2023-03-07 16:02:56.816654,24,2,2,18,8,54
2023-03-07 16:02:57.841729,15,18,10,22,18,83
2023-03-07 16:02:58.869435,19,12,19,5,11,66
2023-03-07 16:02:59.897014,20,6,19,23,14,82
2023-03-07 16:03:00.924713,11,21,17,15,5,69
2023-03-07 16:03:01.952428,18,8,8,19,5,58
2023-03-07 16:03:02.977624,11,2,12,2,12,39
2023-03-07 16:03:04.005073,6,21,10,7,23,67
2023-03-07 16:03:05.029149,17,19,2,17,19,74
2023-03-07 16:03:06.056437,7,20,2,23,21,73
2023-03-07 16:03:07.080137,15,23,23,14,17,92
2023-03-07 16:03:08.109115,13,22,5,24,7,71
2023-03-07 16:03:09.136842,15,4,17,12,11,59
2023-03-07 16:03:10.164541,20,22,6,11,24,83
2023-03-07 16:03:11.192104,4,7,5,24,19,59
2023-03-07 16:03:12.216071,12,9,9,4,5,39
2023-03-07 16:03:13.240900,23,19,8,2,4,56
2023-03-07 16:03:14.264854,7,8,16,7,20,58
2023-03-07 16:03:15.288556,4,4,4,2,3,17
2023-03-07 16:03:16.308381,12,2,13,19,13,59
2023-03-07 16:03:17.335709,14,9,2,16,2,43
2023-03-07 16:03:18.359542,24,20,24,12,22,102
2023-03-07 16:03:19.388214,14,23,17,2,21,77
2023-03-07 16:03:20.415904,6,22,5,3,24,60
2023-03-07 16:03:21.439894,15,9,6,12,10,52
2023-03-07 16:03:22.463724,6,3,6,17,8,40
2023-03-07 16:03:23.487302,3,8,8,4,19,42
2023-03-07 16:03:24.510880,3,12,17,21,11,64
2023-03-07 16:03:25.536093,19,9,5,16,4,53
2023-03-07 16:03:26.559785,15,8,20,8,7,58
2023-03-07 16:03:27.583519,23,20,4,6,23,76
2023-03-07 16:03:28.607202,4,5,24,11,12,56
2023-03-07 16:03:29.631018,8,11,12,9,7,47
2023-03-07 16:03:30.654475,5,5,3,14,22,49
2023-03-07 16:03:31.682760,13,5,10,10,12,50
2023-03-07 16:03:32.706836,3,3,8,2,8,24
2023-03-07 16:03:33.726691,23,8,20,7,21,79
2023-03-07 16:03:34.750533,9,5,13,19,22,68
2023-03-07 16:03:35.774239,23,2,17,15,18,75
2023-03-07 16:03:36.799204,11,21,24,12,18,86
2023-03-07 16:03:37.826907,9,15,7,8,23,62
2023-03-07 16:03:38.850471,12,3,9,14,13,51
2023-03-07 16:03:39.874313,8,6,2,23,2,41
2023-03-07 16:03:40.897888,14,3,14,9,4,44
2023-03-07 16:03:41.921445,5,8,12,11,17,53
2023-03-07 16:03:42.946560,3,18,10,9,4,44
2023-03-07 16:03:43.969939,21,6,22,10,22,81
2023-03-07 16:03:44.997520,23,10,2,5,23,63
2023-03-07 16:03:46.021194,5,2,14,10,10,41
2023-03-07 16:03:47.045349,14,23,11,10,16,74
2023-03-07 16:03:48.072798,23,14,12,11,23,83
2023-03-07 16:03:49.101763,12,13,9,4,5,43
2023-03-07 16:03:50.125842,21,23,8,22,4,78
2023-03-07 16:03:51.153055,3,3,5,11,18,40
2023-03-07 16:03:52.177119,8,16,4,7,5,40
2023-03-07 16:03:53.201806,20,9,21,16,2,68
2023-03-07 16:03:54.229509,5,4,17,11,21,58
2023-03-07 16:03:55.257229,9,6,3,15,14,47
2023-03-07 16:03:56.281187,20,6,6,7,19,58
2023-03-07 16:03:57.304447,16,13,12,21,17,79
2023-03-07 16:03:58.333272,21,11,19,22,15,88
2023-03-07 16:03:59.361246,4,22,20,9,9,64
2023-03-07 16:04:00.385120,15,11,2,19,5,52
2023-03-07 16:04:01.412701,19,4,3,16,23,65
2023-03-07 16:04:02.436657,24,13,2,5,15,59
2023-03-07 16:04:03.465221,13,13,2,19,19,66
2023-03-07 16:04:04.493180,17,23,5,6,11,62
2023-03-07 16:04:05.517006,18,17,2,11,16,64
2023-03-07 16:04:06.544448,21,7,19,10,17,74
2023-03-07 16:04:07.568417,18,5,11,10,23,67
2023-03-07 16:04:08.592244,4,3,10,18,20,55
2023-03-07 16:04:09.616783,9,10,4,15,16,54
2023-03-07 16:04:10.640484,7,20,4,20,4,55
2023-03-07 16:04:11.664066,17,15,23,9,17,81
2023-03-07 16:04:12.691802,17,19,22,6,14,78
2023-03-07 16:04:13.715885,17,22,10,2,13,64
2023-03-07 16:04:14.740833,15,11,9,2,10,47
2023-03-07 16:04:15.768160,17,15,2,12,8,54
2023-03-07 16:04:16.792236,14,10,6,12,6,48
2023-03-07 16:04:17.815814,4,15,6,18,17,60
2023-03-07 16:04:18.839640,14,2,7,2,20,45
2023-03-07 16:04:19.863106,11,21,5,22,10,69
2023-03-07 16:04:20.888302,18,12,11,22,22,85
2023-03-07 16:04:21.915874,14,15,5,17,23,74
2023-03-07 16:04:22.943160,2,5,2,14,3,26
2023-03-07 16:04:23.966925,24,5,24,14,15,82
2023-03-07 16:04:24.990823,8,6,13,16,18,61
2023-03-07 16:04:26.014696,13,20,18,5,17,73
2023-03-07 16:04:27.043441,17,4,7,23,22,73
2023-03-07 16:04:28.071092,2,21,8,5,12,48
2023-03-07 16:04:29.095049,21,15,5,22,20,83
2023-03-07 16:04:30.122624,12,14,20,11,23,80
2023-03-07 16:04:31.151577,4,17,10,4,11,46
2023-03-07 16:04:32.179164,24,16,2,13,9,64
2023-03-07 16:04:33.206859,9,12,9,6,9,45
2023-03-07 16:04:34.230690,2,5,13,20,20,60
2023-03-07 16:04:35.254340,24,20,3,2,16,65
2023-03-07 16:04:36.278057,19,23,8,15,6,71
2023-03-07 16:04:37.302870,20,20,14,24,20,98
2023-03-07 16:04:38.330750,19,8,9,24,11,71
2023-03-07 16:04:39.358329,9,2,5,23,24,63
2023-03-07 16:04:40.382152,6,5,20,14,3,48
2023-03-07 16:04:41.405855,16,17,10,22,22,87
2023-03-07 16:04:42.434812,8,10,16,12,21,67
2023-03-07 16:04:43.462398,24,7,9,4,18,62
2023-03-07 16:04:44.486346,19,24,3,22,24,92
2023-03-07 16:04:45.513793,11,22,11,24,7,75
2023-03-07 16:04:46.537873,6,22,11,20,9,68
2023-03-07 16:04:47.562827,4,6,6,19,15,50
2023-03-07 16:04:48.586108,19,10,9,22,5,65
2023-03-07 16:04:49.609822,12,13,14,21,11,71
2023-03-07 16:04:50.637685,23,4,16,5,8,56
2023-03-07 16:04:51.661386,6,17,20,9,18,70
2023-03-07 16:04:52.685215,7,15,10,21,17,70
2023-03-07 16:04:53.710298,7,20,19,21,2,69
2023-03-07 16:04:54.733995,18,12,23,22,18,93
2023-03-07 16:04:55.761460,13,22,9,4,18,66
2023-03-07 16:04:56.785403,3,8,12,19,19,61
2023-03-07 16:04:57.808977,10,17,7,23,4,61
2023-03-07 16:04:58.832682,8,17,19,18,13,75
2023-03-07 16:04:59.857761,19,3,22,6,12,62
2023-03-07 16:05:00.881042,9,7,24,10,19,69
2023-03-07 16:05:01.904746,17,8,12,5,13,55
2023-03-07 16:05:02.928622,9,3,14,20,14,60
2023-03-07 16:05:03.952447,16,3,4,13,14,50
2023-03-07 16:05:04.976271,3,8,14,7,13,45
2023-03-07 16:05:05.999727,11,12,6,21,10,60
2023-03-07 16:05:07.024806,21,21,10,2,21,75
2023-03-07 16:05:08.052258,5,13,7,19,15,59
2023-03-07 16:05:09.076209,11,19,6,18,16,70
2023-03-07 16:05:10.100037,13,8,8,7,11,47
2023-03-07 16:05:11.123616,5,2,6,2,22,37
2023-03-07 16:05:12.147080,23,16,7,15,16,77
2023-03-07 16:05:13.172276,4,15,10,4,11,44
2023-03-07 16:05:14.195804,14,14,21,5,20,74
2023-03-07 16:05:15.223255,18,23,6,19,21,87
2023-03-07 16:05:16.251249,24,18,13,12,14,81
2023-03-07 16:05:17.280196,18,11,7,23,9,68
2023-03-07 16:05:18.307760,10,21,5,10,5,51
2023-03-07 16:05:19.335609,12,23,3,14,10,62
2023-03-07 16:05:20.363319,21,10,18,21,20,90
2023-03-07 16:05:21.391149,7,17,22,13,9,68
2023-03-07 16:05:22.416357,9,15,12,22,12,70
2023-03-07 16:05:23.443932,11,6,10,11,23,61
2023-03-07 16:05:24.471372,20,15,3,14,17,69
2023-03-07 16:05:25.498944,23,4,23,12,23,85
2023-03-07 16:05:26.522751,20,14,2,23,10,69
2023-03-07 16:05:27.547572,14,16,15,8,22,75
2023-03-07 16:05:28.575146,2,16,5,2,15,40
2023-03-07 16:05:29.599136,16,6,3,20,5,50
2023-03-07 16:05:30.622839,20,21,14,5,16,76
2023-03-07 16:05:31.646793,18,12,20,6,12,68
2023-03-07 16:05:32.670613,13,8,19,24,10,74
2023-03-07 16:05:33.699076,7,10,7,14,17,55
2023-03-07 16:05:34.723152,12,22,24,4,8,70
2023-03-07 16:05:35.746857,9,8,15,22,9,63
2023-03-07 16:05:36.770435,7,11,21,18,17,74
2023-03-07 16:05:37.794269,9,10,23,10,7,59
2023-03-07 16:05:38.817944,10,22,17,11,17,77
2023-03-07 16:05:39.846380,20,14,5,2,9,50
2023-03-07 16:05:40.870207,15,19,12,13,7,66
2023-03-07 16:05:41.894459,19,3,17,19,6,64
2023-03-07 16:05:42.918031,7,19,12,22,18,78
2023-03-07 16:05:43.941730,19,23,8,11,15,76
2023-03-07 16:05:44.965158,19,13,17,4,12,65
2023-03-07 16:05:45.990388,3,6,14,7,4,34
2023-03-07 16:05:47.013970,18,2,19,21,12,72
2023-03-07 16:05:48.041092,9,6,9,13,15,52
2023-03-07 16:05:49.065247,8,12,8,17,12,57
2023-03-07 16:05:50.089324,6,22,21,13,24,86
2023-03-07 16:05:51.117777,19,4,11,19,15,68
2023-03-07 16:05:52.145437,8,9,6,18,18,59
2023-03-07 16:05:53.169264,2,15,8,21,14,60
2023-03-07 16:05:54.196685,5,3,18,10,7,43
2023-03-07 16:05:55.220962,3,17,2,8,16,46
2023-03-07 16:05:56.244781,6,16,13,14,12,61
2023-03-07 16:05:57.273376,17,14,2,4,18,55
2023-03-07 16:05:58.301074,13,12,8,2,3,38
2023-03-07 16:05:59.325023,14,8,13,8,16,59
2023-03-07 16:06:00.352477,4,16,23,14,10,67
2023-03-07 16:06:01.380181,20,3,6,5,10,44
2023-03-07 16:06:02.405400,8,10,10,6,20,54
2023-03-07 16:06:03.432831,5,5,3,4,16,33
2023-03-07 16:06:04.456534,12,21,6,2,12,53
2023-03-07 16:06:05.480197,18,16,5,14,13,66
2023-03-07 16:06:06.507777,11,19,2,15,21,68
2023-03-07 16:06:07.533148,5,7,19,19,23,73
2023-03-07 16:06:08.560728,22,23,13,23,13,94
2023-03-07 16:06:09.588433,12,5,6,23,19,65
2023-03-07 16:06:10.612253,10,20,7,12,4,53
2023-03-07 16:06:11.636081,14,14,17,10,22,77
2023-03-07 16:06:12.664662,24,20,21,21,14,100
2023-03-07 16:06:13.692345,6,5,9,19,22,61
2023-03-07 16:06:14.716471,15,4,7,19,15,60
2023-03-07 16:06:15.740147,15,16,20,6,2,59
2023-03-07 16:06:16.763733,23,17,6,14,9,69
2023-03-07 16:06:17.787258,11,24,6,15,23,79
2023-03-07 16:06:18.812087,3,17,2,12,5,39
2023-03-07 16:06:19.835662,17,2,16,24,21,80
2023-03-07 16:06:20.863801,18,3,13,6,9,49
2023-03-07 16:06:21.887489,18,21,7,15,21,82
2023-03-07 16:06:22.915069,11,21,16,18,5,71
2023-03-07 16:06:23.943895,4,7,8,14,22,55
2023-03-07 16:06:24.967970,18,3,15,7,24,67
2023-03-07 16:06:25.995296,16,16,4,11,15,62
2023-03-07 16:06:27.023144,6,21,7,14,20,68
2023-03-07 16:06:28.047077,21,11,15,17,4,68
2023-03-07 16:06:29.075911,7,14,15,5,3,44
2023-03-07 16:06:30.099455,18,9,22,11,16,76
2023-03-07 16:06:31.126856,21,23,24,19,4,91
2023-03-07 16:06:32.154587,13,2,2,22,21,60
2023-03-07 16:06:33.184121,13,19,6,19,22,79
2023-03-07 16:06:34.211154,9,13,14,13,22,71
2023-03-07 16:06:35.238871,21,9,12,23,14,79
2023-03-07 16:06:36.262968,8,22,21,22,5,78
2023-03-07 16:06:37.286536,3,8,24,12,20,67
2023-03-07 16:06:38.315403,17,3,22,6,11,59
2023-03-07 16:06:39.339061,6,2,19,18,6,51
2023-03-07 16:06:40.362644,2,21,5,13,14,55
2023-03-07 16:06:41.386471,20,2,18,10,8,58
2023-03-07 16:06:42.410071,5,13,20,23,24,85
2023-03-07 16:06:43.440707,12,3,19,2,24,60
2023-03-07 16:06:44.465907,20,8,23,9,5,65
2023-03-07 16:06:45.489609,5,16,21,6,16,64
2023-03-07 16:06:46.514891,8,9,20,24,12,73
2023-03-07 16:06:47.542726,13,18,2,10,13,56
2023-03-07 16:06:48.573904,23,21,23,15,12,94
2023-03-07 16:06:49.602717,15,9,4,4,18,50
2023-03-07 16:06:50.626670,15,5,16,20,20,76
2023-03-07 16:06:51.654125,8,16,4,9,18,55
2023-03-07 16:06:52.678081,12,6,2,9,4,33
2023-03-07 16:06:53.701631,14,11,7,5,2,39
2023-03-07 16:06:54.726488,15,16,15,15,9,70
2023-03-07 16:06:55.754062,5,23,11,24,22,85
2023-03-07 16:06:56.781460,5,12,9,7,7,40
2023-03-07 16:06:57.805170,18,2,6,14,20,60
2023-03-07 16:06:58.829133,13,16,3,19,22,73
2023-03-07 16:06:59.858509,19,7,9,24,20,79
2023-03-07 16:07:00.885571,24,4,4,22,6,60
2023-03-07 16:07:01.909409,14,10,17,14,20,75
2023-03-07 16:07:02.936979,6,20,11,6,18,61
2023-03-07 16:07:03.962064,14,9,3,22,3,51
2023-03-07 16:07:04.991055,22,15,14,6,17,74
2023-03-07 16:07:06.018226,3,14,24,14,9,64
2023-03-07 16:07:07.045662,16,20,20,10,2,68
2023-03-07 16:07:08.073575,5,13,11,18,16,63
2023-03-07 16:07:09.100891,15,2,20,19,7,63
2023-03-07 16:07:10.124906,16,2,8,2,18,46
2023-03-07 16:07:11.149681,8,10,10,22,24,74
2023-03-07 16:07:12.177689,16,2,18,22,2,60
2023-03-07 16:07:13.205116,10,24,6,20,6,66
2023-03-07 16:07:14.229227,9,21,16,20,13,79
2023-03-07 16:07:15.260446,18,15,13,12,17,75
2023-03-07 16:07:16.289365,13,10,7,4,8,42
2023-03-07 16:07:17.313202,14,10,4,11,16,55
2023-03-07 16:07:18.340649,14,20,6,2,17,59
2023-03-07 16:07:19.364864,16,21,21,22,18,98
2023-03-07 16:07:20.397347,6,18,14,14,23,75
2023-03-07 16:07:21.424875,3,12,12,22,9,58
2023-03-07 16:07:22.448532,16,13,6,10,10,55
2023-03-07 16:07:23.477289,11,18,5,24,15,73
2023-03-07 16:07:24.505371,17,18,7,9,17,68
2023-03-07 16:07:25.536865,6,15,4,19,15,59
2023-03-07 16:07:26.565641,24,2,23,18,8,75
2023-03-07 16:07:27.593224,7,16,15,9,24,71
2023-03-07 16:07:28.617169,24,7,13,22,16,82
2023-03-07 16:07:29.644750,15,23,10,8,21,77
2023-03-07 16:07:30.668835,11,8,22,22,4,67
2023-03-07 16:07:31.692284,11,24,4,20,19,78
2023-03-07 16:07:32.717359,5,12,4,22,5,48
2023-03-07 16:07:33.740944,24,17,2,16,5,64
2023-03-07 16:07:34.764470,7,16,18,21,13,75
2023-03-07 16:07:35.791932,3,7,2,6,2,20
2023-03-07 16:07:36.811888,5,9,13,21,23,71
2023-03-07 16:07:37.835758,3,2,13,10,12,40
2023-03-07 16:07:38.860707,21,21,3,2,11,58
2023-03-07 16:07:39.884540,16,24,9,8,2,59
2023-03-07 16:07:40.908115,13,14,9,4,21,61
2023-03-07 16:07:41.931937,20,18,9,4,17,68
2023-03-07 16:07:42.955779,4,24,20,7,2,57
2023-03-07 16:07:43.979351,15,19,10,21,15,80
2023-03-07 16:07:45.008049,18,2,4,8,19,51
2023-03-07 16:07:46.031887,20,2,5,24,3,54
2023-03-07 16:07:47.055584,22,16,23,16,13,90
2023-03-07 16:07:48.082860,10,21,16,20,9,76
2023-03-07 16:07:49.106947,2,8,22,9,5,46
2023-03-07 16:07:50.130564,19,3,4,24,10,60
2023-03-07 16:07:51.155639,13,13,19,10,20,75
2023-03-07 16:07:52.183214,22,6,6,24,6,64
2023-03-07 16:07:53.207048,4,22,14,13,24,77
2023-03-07 16:07:54.234502,20,8,5,2,9,44
2023-03-07 16:07:55.258355,19,12,6,11,14,62
2023-03-07 16:07:56.283534,18,12,10,22,22,84
2023-03-07 16:07:57.310985,7,3,9,20,16,55
2023-03-07 16:07:58.334690,7,8,4,14,17,50
2023-03-07 16:07:59.358520,10,13,13,12,5,53
2023-03-07 16:08:00.382047,7,12,4,8,15,46
2023-03-07 16:08:01.409132,17,6,19,10,15,67
2023-03-07 16:08:02.434330,22,20,15,21,8,86
2023-03-07 16:08:03.458583,10,10,12,9,21,62
2023-03-07 16:08:04.485774,22,12,19,17,3,73
2023-03-07 16:08:05.513557,9,24,18,7,13,71
2023-03-07 16:08:06.543896,15,19,21,18,13,86
2023-03-07 16:08:07.573888,14,7,7,3,21,52
2023-03-07 16:08:08.598977,19,24,21,12,14,90
2023-03-07 16:08:09.626552,9,11,12,3,8,43
2023-03-07 16:08:10.650388,9,9,4,17,2,41
2023-03-07 16:08:11.674096,6,19,9,12,6,52
2023-03-07 16:08:12.697791,6,10,8,14,17,55
2023-03-07 16:08:13.724933,10,9,2,6,22,49
2023-03-07 16:08:14.750007,4,3,2,22,20,51
2023-03-07 16:08:15.774257,24,21,5,16,16,82
2023-03-07 16:08:16.801589,22,9,8,15,19,73
2023-03-07 16:08:17.825451,24,10,23,2,20,79
2023-03-07 16:08:18.852977,12,11,22,11,10,66
2023-03-07 16:08:19.881943,4,15,16,20,7,62
2023-03-07 16:08:20.905900,9,23,7,20,14,73
2023-03-07 16:08:21.929623,16,12,12,15,19,74
2023-03-07 16:08:22.957056,6,21,21,22,11,81
2023-03-07 16:08:23.981156,10,13,3,10,24,60
2023-03-07 16:08:25.009715,24,17,16,10,6,73
2023-03-07 16:08:26.036988,24,2,13,16,17,72
2023-03-07 16:08:27.064960,24,18,19,17,4,82
2023-03-07 16:08:28.092661,11,10,24,3,20,68
2023-03-07 16:08:29.120402,3,2,22,23,2,52
2023-03-07 16:08:30.145491,22,21,13,14,23,93
2023-03-07 16:08:31.173307,19,5,3,23,24,74
2023-03-07 16:08:32.200759,11,9,4,3,8,35
2023-03-07 16:08:33.224713,13,9,24,6,23,75
2023-03-07 16:08:34.248541,14,6,8,7,6,41
2023-03-07 16:08:35.273243,18,8,22,5,3,56
2023-03-07 16:08:36.297207,4,16,2,13,16,51
2023-03-07 16:08:37.324526,5,3,6,9,19,42
2023-03-07 16:08:38.348354,12,14,20,14,17,77
2023-03-07 16:08:39.375887,6,17,3,13,22,61
2023-03-07 16:08:40.399461,15,2,23,21,10,71
2023-03-07 16:08:41.424957,10,15,7,5,14,51
2023-03-07 16:08:42.448674,18,7,16,8,6,55
2023-03-07 16:08:43.472247,2,14,5,22,19,62
2023-03-07 16:08:44.499696,10,6,17,16,14,63
2023-03-07 16:08:45.523770,5,18,9,9,15,56
2023-03-07 16:08:46.547228,6,24,5,21,19,75
2023-03-07 16:08:47.572305,2,20,10,12,17,61
2023-03-07 16:08:48.599767,6,20,8,6,2,42
2023-03-07 16:08:49.623543,19,3,11,4,20,57
2023-03-07 16:08:50.647543,15,6,3,6,12,42
2023-03-07 16:08:51.670831,24,9,10,4,3,50
2023-03-07 16:08:52.694528,22,16,3,11,20,72
2023-03-07 16:08:53.719759,7,18,5,7,19,56
2023-03-07 16:08:54.743586,3,14,11,24,18,70
2023-03-07 16:08:55.767303,6,9,10,15,7,47
2023-03-07 16:08:56.790884,16,23,17,9,24,89
2023-03-07 16:08:57.814713,8,8,17,19,10,62
2023-03-07 16:08:58.838287,6,20,15,10,2,53
2023-03-07 16:08:59.863240,22,3,21,2,4,52
2023-03-07 16:09:00.886962,12,7,9,11,15,54
2023-03-07 16:09:01.910774,10,18,13,20,6,67
2023-03-07 16:09:02.938099,5,22,17,21,5,70
2023-03-07 16:09:03.961771,24,22,20,9,12,87
2023-03-07 16:09:04.985709,13,11,21,18,2,65
2023-03-07 16:09:06.009133,11,3,10,3,23,50
2023-03-07 16:09:07.034580,21,6,17,19,11,74
2023-03-07 16:09:08.061991,7,4,12,16,20,59
2023-03-07 16:09:09.086070,6,9,9,14,23,61
2023-03-07 16:09:10.109519,17,19,18,7,5,66
2023-03-07 16:09:11.133547,16,15,18,18,19,86
2023-03-07 16:09:12.162052,4,21,18,6,6,55
2023-03-07 16:09:13.185893,7,8,23,2,8,48
2023-03-07 16:09:14.209585,22,3,22,19,17,83
2023-03-07 16:09:15.237164,22,12,13,5,5,57
2023-03-07 16:09:16.261242,16,20,7,9,2,54
2023-03-07 16:09:17.284521,14,5,24,20,17,80
2023-03-07 16:09:18.309463,17,22,20,23,22,104
2023-03-07 16:09:19.337188,2,5,8,7,5,27
2023-03-07 16:09:20.360924,11,13,7,23,19,73
2023-03-07 16:09:21.385002,2,22,10,18,2,54
2023-03-07 16:09:22.408706,11,3,2,4,4,24
2023-03-07 16:09:23.432029,20,11,10,13,24,78
2023-03-07 16:09:24.457371,18,10,17,4,5,54
2023-03-07 16:09:25.484689,22,13,21,7,19,82
2023-03-07 16:09:26.512389,12,10,4,24,22,72
2023-03-07 16:09:27.540092,5,22,7,5,21,60
2023-03-07 16:09:28.564051,3,24,12,22,18,79
2023-03-07 16:09:29.592591,7,13,19,19,8,66
2023-03-07 16:09:30.616544,10,5,6,20,9,50
2023-03-07 16:09:31.640237,24,16,21,10,8,79
2023-03-07 16:09:32.667863,3,17,13,15,7,55
2023-03-07 16:09:33.695561,6,10,7,16,21,60
2023-03-07 16:09:34.720888,19,12,5,7,16,59
2023-03-07 16:09:35.748215,9,8,10,3,15,45
2023-03-07 16:09:36.772308,6,9,14,9,13,51
2023-03-07 16:09:37.795999,6,11,8,6,20,51
2023-03-07 16:09:38.819494,10,3,18,22,24,77
2023-03-07 16:09:39.848404,17,24,24,21,20,106
2023-03-07 16:09:40.876234,7,6,20,20,24,77
2023-03-07 16:09:41.899933,4,22,13,9,18,66
2023-03-07 16:09:42.923511,13,7,5,17,16,58
2023-03-07 16:09:43.947046,7,18,16,16,3,60
2023-03-07 16:09:44.971032,22,15,20,6,19,82
2023-03-07 16:09:45.999744,22,2,6,20,13,63
2023-03-07 16:09:47.023825,16,16,11,22,18,83
2023-03-07 16:09:48.051276,19,16,19,16,11,81
2023-03-07 16:09:49.078984,17,24,24,23,20,108
2023-03-07 16:09:50.106683,11,13,8,23,5,60
2023-03-07 16:09:51.131759,22,2,15,22,19,80
2023-03-07 16:09:52.159207,5,11,19,16,2,53
2023-03-07 16:09:53.183291,10,13,10,18,18,69
2023-03-07 16:09:54.210868,3,5,5,14,11,38
2023-03-07 16:09:55.234282,22,13,4,14,18,71
2023-03-07 16:09:56.259227,17,15,12,18,17,79
2023-03-07 16:09:57.286799,5,17,16,17,13,68
2023-03-07 16:09:58.314683,19,8,21,10,15,73
2023-03-07 16:09:59.342387,6,18,22,18,3,67
2023-03-07 16:10:00.366464,11,12,20,6,18,67
2023-03-07 16:10:01.395043,3,4,24,12,13,56
2023-03-07 16:10:02.422740,13,12,15,3,7,50
2023-03-07 16:10:03.450447,6,11,24,16,12,69
2023-03-07 16:10:04.474530,18,5,8,15,13,59
2023-03-07 16:10:05.498229,22,10,2,7,10,51
2023-03-07 16:10:06.523177,15,23,15,22,15,90
2023-03-07 16:10:07.550520,15,2,7,24,4,52
2023-03-07 16:10:08.574175,6,7,18,17,20,68
2023-03-07 16:10:09.597742,16,5,15,6,6,48
2023-03-07 16:10:10.621614,3,4,2,19,3,31
2023-03-07 16:10:11.646441,14,20,8,20,18,80
2023-03-07 16:10:12.674147,3,7,17,8,18,53
2023-03-07 16:10:13.697982,4,8,13,21,7,53
2023-03-07 16:10:14.721803,22,19,15,6,18,80
2023-03-07 16:10:15.745630,6,18,24,16,18,82
2023-03-07 16:10:16.772956,24,21,12,23,20,100
2023-03-07 16:10:17.801910,14,20,20,7,4,65
2023-03-07 16:10:18.825988,7,2,17,5,4,35
2023-03-07 16:10:19.853553,21,3,2,14,10,50
2023-03-07 16:10:20.876738,17,5,9,18,2,51
2023-03-07 16:10:21.901523,9,8,22,12,23,74
2023-03-07 16:10:22.925506,20,9,6,2,17,54
2023-03-07 16:10:23.949383,20,16,14,3,16,69
2023-03-07 16:10:24.979203,5,19,6,17,13,60
2023-03-07 16:10:26.005543,21,13,3,21,10,68
2023-03-07 16:10:27.033098,3,4,16,14,9,46
2023-03-07 16:10:28.056967,7,20,4,19,17,67
2023-03-07 16:10:29.084517,15,7,3,15,9,49
2023-03-07 16:10:30.113369,11,21,10,17,23,82
2023-03-07 16:10:31.141185,15,14,14,18,7,68
2023-03-07 16:10:32.168620,3,19,21,4,5,52
2023-03-07 16:10:33.192461,7,11,10,23,8,59
2023-03-07 16:10:34.220985,10,11,23,16,22,82
2023-03-07 16:10:35.248817,22,20,13,24,3,82
2023-03-07 16:10:36.272958,13,7,17,18,17,72
2023-03-07 16:10:37.300387,6,6,22,8,8,50
2023-03-07 16:10:38.324689,21,4,12,14,20,71
2023-03-07 16:10:39.349307,17,20,13,13,5,68
2023-03-07 16:10:40.376883,8,16,19,10,20,73
2023-03-07 16:10:41.404441,12,20,23,5,24,84
2023-03-07 16:10:42.428434,13,5,13,6,22,59
2023-03-07 16:10:43.452117,21,7,8,17,19,72
2023-03-07 16:10:44.476939,5,2,16,6,17,46
2023-03-07 16:10:45.504395,17,4,4,14,10,49
2023-03-07 16:10:46.527923,13,15,19,11,20,78
2023-03-07 16:10:47.555374,21,19,19,19,23,101
2023-03-07 16:10:48.584315,23,6,14,4,2,49
2023-03-07 16:10:49.608595,12,19,4,11,15,61
2023-03-07 16:10:50.639928,5,23,20,2,2,52
2023-03-07 16:10:51.663973,24,6,21,7,8,66
2023-03-07 16:10:52.688690,7,15,18,6,21,67
2023-03-07 16:10:53.716008,7,9,19,7,12,54
2023-03-07 16:10:54.740086,15,10,24,23,18,90
2023-03-07 16:10:55.767801,18,12,7,11,14,62
2023-03-07 16:10:56.795242,22,4,5,10,10,51
2023-03-07 16:10:57.820455,19,16,22,17,21,95
2023-03-07 16:10:58.848052,6,5,10,12,5,38
2023-03-07 16:10:59.871432,7,4,20,19,4,54
2023-03-07 16:11:00.895150,9,22,11,10,12,64
2023-03-07 16:11:01.919267,23,21,3,24,9,80
2023-03-07 16:11:02.942866,24,8,23,6,6,67
2023-03-07 16:11:03.967788,12,16,9,23,22,82
2023-03-07 16:11:04.995239,22,3,24,21,22,92
2023-03-07 16:11:06.022948,24,7,4,16,13,64
2023-03-07 16:11:07.046908,19,9,2,21,3,54
2023-03-07 16:11:08.070343,9,8,19,3,17,56
2023-03-07 16:11:09.095306,11,15,21,16,10,73
2023-03-07 16:11:10.122989,21,14,6,14,13,68
2023-03-07 16:11:11.150956,20,14,23,12,9,78
2023-03-07 16:11:12.177858,2,7,6,4,15,34
2023-03-07 16:11:13.202817,23,12,2,5,15,57
2023-03-07 16:11:14.226776,9,14,8,11,15,57
2023-03-07 16:11:15.250775,10,24,13,14,3,64
2023-03-07 16:11:16.278219,15,16,6,16,4,57
2023-03-07 16:11:17.305922,13,7,21,7,16,64
2023-03-07 16:11:18.331140,3,21,10,4,11,49
2023-03-07 16:11:19.358580,17,21,5,17,7,67
2023-03-07 16:11:20.386151,24,24,16,3,18,85
2023-03-07 16:11:21.414264,10,18,23,19,22,92
2023-03-07 16:11:22.443076,15,8,14,23,2,62
2023-03-07 16:11:23.470635,16,5,10,18,7,56
2023-03-07 16:11:24.494726,17,18,7,3,20,65
2023-03-07 16:11:25.518003,2,23,4,21,22,72
2023-03-07 16:11:26.545443,16,10,10,22,23,81
2023-03-07 16:11:27.574703,17,20,15,19,5,76
2023-03-07 16:11:28.602410,16,24,24,14,9,87
2023-03-07 16:11:29.630107,8,20,11,11,7,57
2023-03-07 16:11:30.654077,14,9,14,9,12,58
2023-03-07 16:11:31.681441,24,8,22,4,6,64
2023-03-07 16:11:32.706098,17,6,16,9,19,67
2023-03-07 16:11:33.730047,12,18,24,8,6,68
2023-03-07 16:11:34.753883,23,4,11,14,10,62
2023-03-07 16:11:35.781078,22,19,20,16,19,96
2023-03-07 16:11:36.813945,20,10,11,24,3,68
2023-03-07 16:11:37.841372,19,23,14,18,6,80
2023-03-07 16:11:38.868879,22,22,17,17,16,94
2023-03-07 16:11:39.897974,10,19,23,14,6,72
2023-03-07 16:11:40.925968,8,6,19,5,23,61
2023-03-07 16:11:41.953303,21,5,24,6,13,69
2023-03-07 16:11:42.977253,2,10,18,16,21,67
2023-03-07 16:11:44.002326,13,2,9,21,17,62
2023-03-07 16:11:45.026029,9,15,15,5,22,66
2023-03-07 16:11:46.049613,6,6,9,6,19,46
2023-03-07 16:11:47.076943,13,8,15,20,6,62
2023-03-07 16:11:48.100765,19,9,3,11,21,63
2023-03-07 16:11:49.125846,6,17,24,13,11,71
2023-03-07 16:11:50.153171,7,11,13,10,10,51
2023-03-07 16:11:51.176965,7,2,2,17,10,38
2023-03-07 16:11:52.200543,13,12,11,12,8,56
2023-03-07 16:11:53.224787,23,7,15,8,9,62
2023-03-07 16:11:54.248109,7,8,21,2,13,51
2023-03-07 16:11:55.273061,14,13,10,18,3,58
2023-03-07 16:11:56.300641,22,6,3,21,9,61
2023-03-07 16:11:57.328100,19,14,21,16,2,72
2023-03-07 16:11:58.352170,10,19,19,9,5,62
2023-03-07 16:11:59.377000,18,3,16,6,14,57
2023-03-07 16:12:00.400703,8,21,7,17,12,65
2023-03-07 16:12:01.424528,22,13,4,6,3,48
2023-03-07 16:12:02.451616,18,7,18,7,12,62
2023-03-07 16:12:03.475129,18,9,21,14,8,70
2023-03-07 16:12:04.500220,11,16,14,16,5,62
2023-03-07 16:12:05.527668,9,4,17,16,15,61
2023-03-07 16:12:06.555665,11,18,14,20,22,85
2023-03-07 16:12:07.583645,24,9,11,18,10,72
2023-03-07 16:12:08.612323,15,14,23,13,15,80
2023-03-07 16:12:09.640277,16,6,22,15,22,81
2023-03-07 16:12:10.667854,24,22,14,20,11,91
2023-03-07 16:12:11.695556,2,23,17,23,17,82
2023-03-07 16:12:12.726913,6,6,9,19,6,46
2023-03-07 16:12:13.748346,15,13,22,7,4,61
2023-03-07 16:12:14.772050,7,9,24,4,18,62
2023-03-07 16:12:15.795629,5,18,8,2,12,45
2023-03-07 16:12:16.818780,16,12,6,8,22,64
2023-03-07 16:12:17.846250,17,18,19,24,13,91
2023-03-07 16:12:18.871728,15,8,21,16,22,82
2023-03-07 16:12:19.899056,5,2,23,8,2,40
2023-03-07 16:12:20.922884,14,2,15,15,11,57
2023-03-07 16:12:21.946836,17,7,23,24,21,92
2023-03-07 16:12:22.975688,14,5,8,22,18,67
2023-03-07 16:12:23.999244,20,9,20,22,21,92
2023-03-07 16:12:25.026570,7,18,10,13,12,60
2023-03-07 16:12:26.050647,15,9,20,20,20,84
2023-03-07 16:12:27.075478,19,8,11,3,11,52
2023-03-07 16:12:28.103093,19,19,2,9,15,64
2023-03-07 16:12:29.126328,5,23,17,6,20,71
2023-03-07 16:12:30.150037,22,22,8,2,6,60
2023-03-07 16:12:31.173623,8,23,2,14,21,68
2023-03-07 16:12:32.198877,22,9,14,13,19,77
2023-03-07 16:12:33.226588,4,16,11,15,21,67
2023-03-07 16:12:34.254275,9,15,24,10,4,62
2023-03-07 16:12:35.281848,6,22,5,14,4,51
2023-03-07 16:12:36.305802,6,8,22,15,15,66
2023-03-07 16:12:37.330882,8,15,19,8,9,59
2023-03-07 16:12:38.358347,20,3,4,16,12,55
2023-03-07 16:12:39.385917,9,3,3,23,17,55
2023-03-07 16:12:40.409292,22,12,11,16,24,85
2023-03-07 16:12:41.437450,16,12,24,15,24,91
2023-03-07 16:12:42.465949,15,18,21,2,18,74
2023-03-07 16:12:43.493802,14,5,23,14,4,60
2023-03-07 16:12:44.518061,9,24,10,14,14,71
2023-03-07 16:12:45.541762,12,15,13,10,5,55
2023-03-07 16:12:46.569071,22,6,16,17,13,74
2023-03-07 16:12:47.594414,5,14,16,24,15,74
2023-03-07 16:12:48.621876,4,18,11,3,16,52
2023-03-07 16:12:49.645820,7,19,22,23,17,88
2023-03-07 16:12:50.673143,2,19,20,14,10,65
2023-03-07 16:12:51.697231,21,18,9,4,6,58
2023-03-07 16:12:52.722057,2,20,19,6,5,52
2023-03-07 16:12:53.745767,14,17,24,19,7,81
2023-03-07 16:12:54.773040,24,16,6,10,18,74
2023-03-07 16:12:55.800602,21,6,20,14,9,70
2023-03-07 16:12:56.824569,19,8,17,20,18,82
2023-03-07 16:12:57.853609,18,24,3,22,7,74
2023-03-07 16:12:58.881271,21,10,7,24,23,85
2023-03-07 16:12:59.908983,8,10,17,17,15,67
2023-03-07 16:13:00.936517,21,18,9,22,5,75
2023-03-07 16:13:01.960751,16,12,20,4,18,70
2023-03-07 16:13:02.989329,5,18,2,18,5,48
2023-03-07 16:13:04.013281,5,22,18,18,3,66
2023-03-07 16:13:05.040735,15,22,14,19,14,84
2023-03-07 16:13:06.068570,11,9,24,21,8,73
2023-03-07 16:13:07.092373,20,23,21,12,21,97
2023-03-07 16:13:08.120914,3,12,4,15,22,56
2023-03-07 16:13:09.144617,20,24,15,23,21,103
2023-03-07 16:13:10.172623,6,24,22,5,16,73
2023-03-07 16:13:11.196454,7,10,4,7,8,36
2023-03-07 16:13:12.223830,11,3,24,24,2,64
2023-03-07 16:13:13.248732,3,11,24,3,23,64
2023-03-07 16:13:14.272558,2,7,21,12,10,52
2023-03-07 16:13:15.296141,11,10,8,18,4,51
2023-03-07 16:13:16.319837,13,22,24,15,22,96
2023-03-07 16:13:17.353122,22,3,16,21,14,76
2023-03-07 16:13:18.380378,5,22,20,7,4,58
2023-03-07 16:13:19.404319,20,8,11,17,4,60
2023-03-07 16:13:20.427479,4,16,22,5,19,66
2023-03-07 16:13:21.452316,11,2,3,8,22,46
2023-03-07 16:13:22.476023,12,20,16,15,13,76
2023-03-07 16:13:23.504013,7,9,6,2,23,47
2023-03-07 16:13:24.527725,19,5,20,18,3,65
2023-03-07 16:13:25.551559,6,21,13,9,2,51
2023-03-07 16:13:26.576254,22,13,11,2,23,71
2023-03-07 16:13:27.604081,21,4,13,13,22,73
2023-03-07 16:13:28.631534,22,9,24,17,19,91
2023-03-07 16:13:29.659223,7,20,2,21,3,53
2023-03-07 16:13:30.683061,9,14,12,11,12,58
2023-03-07 16:13:31.711752,12,8,9,14,19,62
2023-03-07 16:13:32.739467,9,7,11,2,20,49
2023-03-07 16:13:33.763117,17,12,16,8,21,74
2023-03-07 16:13:34.794344,12,16,23,3,6,60
2023-03-07 16:13:35.819818,19,18,3,14,24,78
2023-03-07 16:13:36.847276,3,12,22,16,24,77
2023-03-07 16:13:37.871350,17,18,8,21,22,86
2023-03-07 16:13:38.898673,12,18,10,24,17,81
2023-03-07 16:13:39.931383,14,2,8,7,11,42
2023-03-07 16:13:40.955345,19,18,7,22,23,89
2023-03-07 16:13:41.982914,5,5,11,17,10,48
2023-03-07 16:13:43.007001,2,4,17,4,24,51
2023-03-07 16:13:44.030442,5,23,22,18,5,73
2023-03-07 16:13:45.059308,15,19,6,21,10,71
2023-03-07 16:13:46.086429,5,24,17,8,10,64
2023-03-07 16:13:47.110262,8,13,22,8,17,68
2023-03-07 16:13:48.134135,15,11,11,16,13,66
2023-03-07 16:13:49.162947,11,16,13,17,18,75
2023-03-07 16:13:50.195671,6,2,14,19,7,48
2023-03-07 16:13:51.218486,12,21,9,22,18,82
2023-03-07 16:13:52.247064,10,6,12,9,10,47
2023-03-07 16:13:53.271136,9,15,7,4,11,46
2023-03-07 16:13:54.294719,15,15,11,23,24,88
2023-03-07 16:13:55.325926,8,19,3,23,24,77
2023-03-07 16:13:56.351132,7,17,18,10,5,57
2023-03-07 16:13:57.374950,24,19,4,7,19,73
2023-03-07 16:13:58.398362,8,12,15,5,10,50
2023-03-07 16:13:59.422062,10,19,21,6,3,59
2023-03-07 16:14:00.445798,13,8,22,15,19,77
2023-03-07 16:14:01.473640,6,18,20,24,5,73
2023-03-07 16:14:02.498599,19,17,20,23,12,91
2023-03-07 16:14:03.526173,12,5,3,2,24,46
2023-03-07 16:14:04.550008,13,6,3,23,2,47
2023-03-07 16:14:05.573705,11,9,3,13,7,43
2023-03-07 16:14:06.597293,3,7,3,12,10,35
2023-03-07 16:14:07.621111,20,4,7,12,18,61
2023-03-07 16:14:08.646063,8,19,3,15,22,67
2023-03-07 16:14:09.669892,9,7,8,22,14,60
2023-03-07 16:14:10.693518,5,7,9,11,3,35
2023-03-07 16:14:11.716881,5,15,15,15,17,67
2023-03-07 16:14:12.740721,18,2,2,23,6,51
2023-03-07 16:14:13.764436,24,9,20,3,16,72
2023-03-07 16:14:14.789535,7,19,5,24,3,58
2023-03-07 16:14:15.813233,18,7,14,18,3,60
2023-03-07 16:14:16.837064,24,23,13,9,13,82
2023-03-07 16:14:17.864392,4,3,11,18,20,56
2023-03-07 16:14:18.888351,7,11,13,19,13,63
2023-03-07 16:14:19.912176,17,12,7,2,19,57
2023-03-07 16:14:20.937001,21,4,18,7,5,55
2023-03-07 16:14:21.960827,9,14,19,5,12,59
2023-03-07 16:14:22.984533,15,23,10,17,6,71
2023-03-07 16:14:24.011697,22,8,7,18,24,79
2023-03-07 16:14:25.035515,20,5,23,18,12,78
2023-03-07 16:14:26.059342,10,21,23,11,18,83
2023-03-07 16:14:27.088217,13,3,16,16,23,71
2023-03-07 16:14:28.116042,16,19,3,9,5,52
2023-03-07 16:14:29.139995,6,15,24,14,13,72
2023-03-07 16:14:30.167449,4,17,13,5,12,51
2023-03-07 16:14:31.191409,2,7,20,21,18,68
2023-03-07 16:14:32.216359,24,24,3,16,21,88
2023-03-07 16:14:33.243934,22,10,7,13,3,55
2023-03-07 16:14:34.271384,22,17,22,18,5,84
2023-03-07 16:14:35.299093,24,12,7,17,4,64
2023-03-07 16:14:36.326796,16,21,16,22,15,90
2023-03-07 16:14:37.355726,5,12,6,8,6,37
2023-03-07 16:14:38.379269,8,15,17,2,6,48
2023-03-07 16:14:39.403256,11,9,21,19,4,64
2023-03-07 16:14:40.427232,14,18,9,24,23,88
2023-03-07 16:14:41.454556,20,20,15,15,11,81
2023-03-07 16:14:42.483548,2,23,19,7,13,64
2023-03-07 16:14:43.507601,17,13,2,10,22,64
2023-03-07 16:14:44.534916,8,4,14,8,2,36
2023-03-07 16:14:45.558744,22,14,8,14,3,61
2023-03-07 16:14:46.582571,13,4,4,7,4,32
2023-03-07 16:14:47.606025,19,11,19,19,3,71
2023-03-07 16:14:48.631353,14,5,15,20,22,76
2023-03-07 16:14:49.658886,8,21,3,6,14,52
2023-03-07 16:14:50.682351,15,16,16,4,5,56
2023-03-07 16:14:51.706170,2,18,13,21,18,72
2023-03-07 16:14:52.730162,3,9,8,7,10,37
2023-03-07 16:14:53.753874,7,12,15,4,17,55
2023-03-07 16:14:54.779324,21,19,18,16,11,85
2023-03-07 16:14:55.806405,23,14,22,24,6,89
2023-03-07 16:14:56.833971,12,16,13,9,4,54
2023-03-07 16:14:57.857939,6,8,13,20,18,65
2023-03-07 16:14:58.881504,7,14,15,22,20,78
2023-03-07 16:14:59.906588,12,12,4,18,21,67
2023-03-07 16:15:00.934184,22,11,21,22,9,85
2023-03-07 16:15:01.961739,2,3,14,24,16,59
2023-03-07 16:15:02.989146,3,6,23,15,7,54
2023-03-07 16:15:04.012979,4,7,6,18,5,40
2023-03-07 16:15:05.038099,6,17,12,10,13,58
2023-03-07 16:15:06.069439,10,20,17,7,5,59
2023-03-07 16:15:07.093643,15,4,19,9,14,61
2023-03-07 16:15:08.120831,23,14,11,8,12,68
2023-03-07 16:15:09.149787,24,11,17,17,6,75
2023-03-07 16:15:10.177608,13,6,15,2,12,48
2023-03-07 16:15:11.205324,21,6,24,24,19,94
2023-03-07 16:15:12.230269,17,23,14,15,9,78
2023-03-07 16:15:13.257721,2,3,21,23,14,63
2023-03-07 16:15:14.281680,13,7,10,5,18,53
2023-03-07 16:15:15.305082,14,18,8,2,12,54
2023-03-07 16:15:16.328932,23,16,13,13,21,86
2023-03-07 16:15:17.356379,15,14,7,4,13,53
2023-03-07 16:15:18.381612,14,21,22,21,17,95
2023-03-07 16:15:19.409193,13,3,6,10,19,51
2023-03-07 16:15:20.433151,23,22,11,12,12,80
2023-03-07 16:15:21.464476,15,17,15,16,20,83
2023-03-07 16:15:22.493601,18,3,14,22,10,67
2023-03-07 16:15:23.520994,5,12,4,9,11,41
2023-03-07 16:15:24.544867,16,14,5,13,21,69
2023-03-07 16:15:25.572399,11,20,24,23,23,101
2023-03-07 16:15:26.605102,11,10,15,11,21,68
2023-03-07 16:15:27.632808,16,8,12,8,3,47
2023-03-07 16:15:28.656475,19,13,4,23,15,74
2023-03-07 16:15:29.680039,9,13,14,19,17,72
2023-03-07 16:15:30.705440,8,18,14,10,21,71
2023-03-07 16:15:31.732741,15,2,13,24,14,68
2023-03-07 16:15:32.760448,4,4,19,16,12,55
2023-03-07 16:15:33.784408,14,21,9,3,12,59
2023-03-07 16:15:34.808111,5,23,4,6,19,57
2023-03-07 16:15:35.832938,15,20,22,4,6,67
2023-03-07 16:15:36.860506,5,16,9,9,21,60
2023-03-07 16:15:37.884603,11,12,22,24,2,71
2023-03-07 16:15:38.911791,10,14,18,23,16,81
2023-03-07 16:15:39.939623,8,21,2,2,23,56
2023-03-07 16:15:40.964417,23,17,7,3,18,68
2023-03-07 16:15:41.991973,12,8,22,5,3,50
2023-03-07 16:15:43.015937,19,13,21,24,9,86
2023-03-07 16:15:44.043693,6,18,14,12,22,72
2023-03-07 16:15:45.071383,11,5,18,13,3,50
2023-03-07 16:15:46.096595,15,15,2,15,15,62
2023-03-07 16:15:47.124325,19,20,5,4,17,65
2023-03-07 16:15:48.151740,22,18,8,10,11,69
2023-03-07 16:15:49.179436,20,22,4,22,6,74
2023-03-07 16:15:50.203651,4,16,23,21,22,86
2023-03-07 16:15:51.231959,19,7,15,8,12,61
2023-03-07 16:15:52.256192,7,18,9,5,22,61
2023-03-07 16:15:53.279648,5,24,10,15,11,65
2023-03-07 16:15:54.306905,4,18,7,22,19,70
2023-03-07 16:15:55.330735,19,6,7,2,19,53
2023-03-07 16:15:56.355870,16,16,17,22,16,87
2023-03-07 16:15:57.383843,20,7,5,13,22,67
2023-03-07 16:15:58.407662,4,4,11,22,16,57
2023-03-07 16:15:59.431225,11,14,18,8,2,53
2023-03-07 16:16:00.454960,19,22,7,18,8,74
2023-03-07 16:16:01.478643,11,20,19,16,8,74
2023-03-07 16:16:02.503726,20,18,14,17,5,74
2023-03-07 16:16:03.531045,17,15,18,6,23,79
2023-03-07 16:16:04.558739,22,14,5,9,4,54
2023-03-07 16:16:05.582436,9,17,16,3,24,69
2023-03-07 16:16:06.605979,18,24,23,14,11,90
2023-03-07 16:16:07.634820,15,23,19,20,7,84
2023-03-07 16:16:08.662504,16,4,23,17,12,72
2023-03-07 16:16:09.690639,13,2,19,19,24,77
2023-03-07 16:16:10.718082,22,12,19,8,17,78
2023-03-07 16:16:11.745909,18,3,13,9,21,64
2023-03-07 16:16:12.771276,8,6,2,12,15,43
2023-03-07 16:16:13.794819,24,2,5,2,22,55
2023-03-07 16:16:14.818519,24,20,6,4,5,59
2023-03-07 16:16:15.842224,22,7,23,4,5,61
2023-03-07 16:16:16.865821,3,6,6,9,6,30
2023-03-07 16:16:17.889516,19,4,8,12,17,60
2023-03-07 16:16:18.914718,20,22,19,18,11,90
2023-03-07 16:16:19.942000,22,14,10,8,11,65
2023-03-07 16:16:20.969580,8,6,13,10,9,46
2023-03-07 16:16:21.993745,17,18,9,10,8,62
2023-03-07 16:16:23.021289,7,13,24,24,16,84
2023-03-07 16:16:24.050091,10,13,14,22,5,64
2023-03-07 16:16:25.077798,23,20,6,2,4,55
2023-03-07 16:16:26.101637,2,18,10,4,24,58
2023-03-07 16:16:27.125460,19,22,24,11,13,89
2023-03-07 16:16:28.152910,14,21,6,3,3,47
2023-03-07 16:16:29.177988,18,13,10,6,7,54
2023-03-07 16:16:30.201836,15,20,7,19,19,80
2023-03-07 16:16:31.229121,7,10,10,16,21,64
2023-03-07 16:16:32.256666,7,4,13,19,18,61
2023-03-07 16:16:33.280505,9,9,17,8,17,60
2023-03-07 16:16:34.305459,8,24,3,13,23,71
2023-03-07 16:16:35.329583,11,14,18,22,14,79
2023-03-07 16:16:36.357164,10,15,24,24,4,77
2023-03-07 16:16:37.384729,13,3,13,14,3,46
2023-03-07 16:16:38.408823,19,9,24,10,10,72
2023-03-07 16:16:39.437385,3,19,18,9,4,53
2023-03-07 16:16:40.461353,13,21,15,3,6,58
2023-03-07 16:16:41.488665,7,7,20,21,5,60
2023-03-07 16:16:42.512632,3,21,9,23,15,71
2023-03-07 16:16:43.540224,6,21,18,8,7,60
2023-03-07 16:16:44.564292,12,8,24,22,12,78
2023-03-07 16:16:45.592560,19,16,9,10,3,57
2023-03-07 16:16:46.620264,2,6,13,6,13,40
2023-03-07 16:16:47.644520,3,10,6,15,17,51
2023-03-07 16:16:48.668371,3,9,7,9,9,37
2023-03-07 16:16:49.691803,11,13,18,21,22,85
2023-03-07 16:16:50.720603,21,9,10,15,13,68
2023-03-07 16:16:51.748316,20,3,23,19,19,84
2023-03-07 16:16:52.775908,17,23,11,23,3,77
2023-03-07 16:16:53.800131,18,17,19,5,9,68
2023-03-07 16:16:54.823638,24,10,3,18,22,77
2023-03-07 16:16:55.848645,13,14,21,24,9,81
2023-03-07 16:16:56.875963,4,8,23,17,20,72
2023-03-07 16:16:57.899618,10,4,11,9,10,44
2023-03-07 16:16:58.923565,10,5,15,2,14,46
2023-03-07 16:16:59.947040,21,21,16,16,7,81
2023-03-07 16:17:00.971153,24,17,20,18,15,94
2023-03-07 16:17:01.999853,4,24,15,21,8,72
2023-03-07 16:17:03.023939,5,24,17,23,19,88
2023-03-07 16:17:04.051114,23,12,14,20,6,75
2023-03-07 16:17:05.081750,21,15,15,3,21,75
2023-03-07 16:17:06.107677,14,20,3,10,22,69
2023-03-07 16:17:07.135101,19,11,10,13,3,56
2023-03-07 16:17:08.162683,13,15,8,6,15,57
2023-03-07 16:17:09.191769,14,19,23,24,7,87
2023-03-07 16:17:10.223626,19,15,24,22,10,90
2023-03-07 16:17:11.250758,11,10,13,21,13,68
2023-03-07 16:17:12.279584,13,22,20,18,17,90
2023-03-07 16:17:13.307719,22,12,21,10,4,69
2023-03-07 16:17:14.335287,3,6,5,11,13,38
2023-03-07 16:17:15.359252,19,23,16,13,2,73
2023-03-07 16:17:16.386689,8,20,14,11,18,71
2023-03-07 16:17:17.411898,22,24,15,18,15,94
2023-03-07 16:17:18.439501,19,13,17,17,13,79
2023-03-07 16:17:19.467187,14,6,5,18,19,62
2023-03-07 16:17:20.495042,4,6,9,11,22,52
2023-03-07 16:17:21.519709,11,4,23,6,4,48
2023-03-07 16:17:22.543557,20,16,20,20,19,95
2023-03-07 16:17:23.570695,19,16,12,10,24,81
2023-03-07 16:17:24.598388,14,7,2,17,3,43
2023-03-07 16:17:25.625870,4,20,10,5,7,46
2023-03-07 16:17:26.651106,14,21,24,13,4,76
2023-03-07 16:17:27.678671,23,18,10,4,5,60
2023-03-07 16:17:28.702623,24,13,11,21,16,85
2023-03-07 16:17:29.730217,7,13,3,12,18,53
2023-03-07 16:17:30.759057,3,6,5,5,14,33
2023-03-07 16:17:31.782487,21,20,17,4,13,75
2023-03-07 16:17:32.810193,9,5,7,21,24,66
2023-03-07 16:17:33.834010,13,11,5,5,8,42
2023-03-07 16:17:34.858975,12,23,24,8,7,74
2023-03-07 16:17:35.887411,20,13,13,21,22,89
2023-03-07 16:17:36.913697,19,21,24,4,23,91
2023-03-07 16:17:37.937412,19,4,3,16,23,65
2023-03-07 16:17:38.962671,2,21,10,15,10,58
2023-03-07 16:17:39.990233,5,6,15,10,19,55
2023-03-07 16:17:41.018350,13,17,6,23,10,69
2023-03-07 16:17:42.046773,11,11,20,8,14,64
2023-03-07 16:17:43.074489,11,24,21,10,22,88
2023-03-07 16:17:44.102166,6,9,10,21,3,49
2023-03-07 16:17:45.126133,5,3,9,19,21,57
2023-03-07 16:17:46.153851,15,23,4,12,17,71
2023-03-07 16:17:47.182285,10,17,8,14,3,52
2023-03-07 16:17:48.209737,3,8,2,20,5,38
2023-03-07 16:17:49.233265,10,3,15,5,10,43
2023-03-07 16:17:50.257098,7,9,6,18,16,56
2023-03-07 16:17:51.285701,13,4,21,19,12,69
2023-03-07 16:17:52.309914,24,21,19,3,23,90
2023-03-07 16:17:53.337246,11,5,19,2,16,53
2023-03-07 16:17:54.361199,17,21,11,16,24,89
2023-03-07 16:17:55.389890,16,8,3,17,7,51
2023-03-07 16:17:56.418140,8,23,19,5,19,74
2023-03-07 16:17:57.441430,12,17,12,7,16,64
2023-03-07 16:17:58.468885,5,15,20,10,6,56
2023-03-07 16:17:59.494097,7,7,9,11,2,36
2023-03-07 16:18:00.517671,19,19,16,13,3,70
2023-03-07 16:18:01.549084,13,17,23,5,24,82
2023-03-07 16:18:02.576393,12,20,5,17,15,69
2023-03-07 16:18:03.601610,10,16,22,6,18,72
2023-03-07 16:18:04.629483,24,5,2,12,5,48
2023-03-07 16:18:05.653321,18,8,20,15,24,85
2023-03-07 16:18:06.685796,6,5,2,11,15,39
2023-03-07 16:18:07.709710,2,21,12,18,6,59
2023-03-07 16:18:08.737041,5,7,19,4,19,54
2023-03-07 16:18:09.761000,21,21,20,2,11,75
2023-03-07 16:18:10.788446,17,15,16,9,9,66
2023-03-07 16:18:11.816182,11,11,10,7,21,60
2023-03-07 16:18:12.841101,10,6,5,3,9,33
2023-03-07 16:18:13.864660,7,19,8,24,5,63
2023-03-07 16:18:14.888149,17,3,18,18,7,63
2023-03-07 16:18:15.911921,5,2,10,6,22,45
2023-03-07 16:18:16.935959,18,9,6,13,3,49
2023-03-07 16:18:17.960747,2,13,24,23,3,65
2023-03-07 16:18:18.984833,10,21,13,5,14,63
2023-03-07 16:18:20.012026,19,23,2,22,6,72
2023-03-07 16:18:21.035982,23,15,2,11,19,70
2023-03-07 16:18:22.063488,5,19,3,23,20,70
2023-03-07 16:18:23.088787,9,11,9,15,16,60
2023-03-07 16:18:24.112468,2,14,24,15,5,60
2023-03-07 16:18:25.136169,11,22,24,22,21,100
2023-03-07 16:18:26.163650,6,13,22,18,11,70
2023-03-07 16:18:27.187429,11,17,2,15,11,56
2023-03-07 16:18:28.210858,10,8,20,4,6,48
2023-03-07 16:18:29.235764,14,15,11,10,5,55
2023-03-07 16:18:30.263558,11,17,3,19,23,73
2023-03-07 16:18:31.291254,11,15,2,14,7,49
2023-03-07 16:18:32.315340,11,24,23,17,4,79
2023-03-07 16:18:33.342792,11,5,3,11,9,39
2023-03-07 16:18:34.367872,17,16,10,5,4,52
2023-03-07 16:18:35.395578,15,22,4,5,21,67
2023-03-07 16:18:36.423027,11,23,18,15,22,89
2023-03-07 16:18:37.450851,7,21,7,5,7,47
2023-03-07 16:18:38.474549,13,3,17,11,17,61
2023-03-07 16:18:39.503499,24,11,2,9,17,63
2023-03-07 16:18:40.530917,21,17,8,6,19,71
2023-03-07 16:18:41.555136,6,13,12,8,8,47
2023-03-07 16:18:42.578999,19,7,14,3,9,52
2023-03-07 16:18:43.602443,15,3,3,13,19,53
2023-03-07 16:18:44.627513,16,13,6,20,24,79
2023-03-07 16:18:45.654981,8,23,7,17,22,77
2023-03-07 16:18:46.678700,2,10,17,8,24,61
2023-03-07 16:18:47.706287,21,10,8,2,18,59
2023-03-07 16:18:48.730967,13,9,24,13,18,77
2023-03-07 16:18:49.758531,21,4,2,8,13,48
2023-03-07 16:18:50.782497,6,16,23,24,13,82
2023-03-07 16:18:51.809811,3,22,15,22,11,73
2023-03-07 16:18:52.837511,15,22,18,22,18,95
2023-03-07 16:18:53.866048,11,23,17,10,6,67
2023-03-07 16:18:54.893752,15,19,12,22,10,78
2023-03-07 16:18:55.921885,6,19,24,15,3,67
2023-03-07 16:18:56.946959,23,4,11,14,10,62
2023-03-07 16:18:57.980306,19,23,19,22,10,93
2023-03-07 16:18:59.010856,5,2,9,6,20,42
2023-03-07 16:19:00.034693,21,19,19,23,11,93
2023-03-07 16:19:01.062397,23,2,10,24,20,79
2023-03-07 16:19:02.089961,6,11,18,12,5,52
2023-03-07 16:19:03.117938,15,8,8,13,2,46
2023-03-07 16:19:04.142505,8,22,21,5,11,67
2023-03-07 16:19:05.166337,4,2,12,15,24,57
2023-03-07 16:19:06.189731,5,16,21,8,23,73
2023-03-07 16:19:07.213312,13,21,20,22,12,88
2023-03-07 16:19:08.248449,18,14,10,15,22,79
2023-03-07 16:19:09.277629,23,3,12,13,9,60
2023-03-07 16:19:10.301609,14,14,21,23,13,85
2023-03-07 16:19:11.330551,10,13,14,15,5,57
2023-03-07 16:19:12.357998,16,5,7,18,24,70
2023-03-07 16:19:13.382085,17,14,22,23,12,88
2023-03-07 16:19:14.409526,24,17,18,16,17,92
2023-03-07 16:19:15.438343,2,11,5,13,17,48
2023-03-07 16:19:16.466056,6,23,4,18,2,53
2023-03-07 16:19:17.489885,14,16,21,23,5,79
2023-03-07 16:19:18.520936,6,18,8,12,23,67
2023-03-07 16:19:19.545860,18,17,2,10,7,54
2023-03-07 16:19:20.569825,13,5,13,18,8,57
2023-03-07 16:19:21.593955,7,14,10,14,6,51
2023-03-07 16:19:22.617524,14,11,6,19,23,73
2023-03-07 16:19:23.650276,15,12,21,13,12,73
2023-03-07 16:19:24.677812,16,15,16,24,14,85
2023-03-07 16:19:25.705516,18,17,12,11,16,74
2023-03-07 16:19:26.733346,16,13,14,2,4,49
2023-03-07 16:19:27.757046,17,11,3,5,17,53
2023-03-07 16:19:28.789660,10,17,16,12,13,68
2023-03-07 16:19:29.817326,19,5,16,15,7,62
2023-03-07 16:19:30.841152,12,22,4,5,12,55
2023-03-07 16:19:31.869552,2,23,4,5,8,42
2023-03-07 16:19:32.893381,18,6,12,14,6,56
2023-03-07 16:19:33.925284,21,3,9,21,12,66
2023-03-07 16:19:34.949087,21,7,22,5,5,60
2023-03-07 16:19:35.973789,2,14,14,5,22,57
2023-03-07 16:19:37.001224,22,19,4,21,14,80
2023-03-07 16:19:38.028616,18,8,24,9,14,73
2023-03-07 16:19:39.053626,16,9,18,4,17,64
2023-03-07 16:19:40.076729,5,8,19,8,2,42
2023-03-07 16:19:41.100054,16,17,16,12,13,74
2023-03-07 16:19:42.129006,24,11,22,8,23,88
2023-03-07 16:19:43.156709,23,14,6,4,6,53
2023-03-07 16:19:44.180235,23,13,2,18,20,76
2023-03-07 16:19:45.203993,7,17,19,17,21,81
2023-03-07 16:19:46.227876,22,4,4,2,11,43
2023-03-07 16:19:47.252890,3,9,20,24,12,68
2023-03-07 16:19:48.276809,3,17,20,16,5,61
2023-03-07 16:19:49.300559,21,11,4,5,11,52
2023-03-07 16:19:50.324406,23,4,21,9,6,63
2023-03-07 16:19:51.347965,8,18,4,19,5,54
2023-03-07 16:19:52.371531,3,20,3,22,11,59
2023-03-07 16:19:53.395226,5,24,10,14,15,68
2023-03-07 16:19:54.420325,4,21,13,11,12,61
2023-03-07 16:19:55.447762,4,18,20,20,7,69
2023-03-07 16:19:56.475649,13,5,2,7,10,37
2023-03-07 16:19:57.498598,17,19,15,20,5,76
2023-03-07 16:19:58.527578,22,10,20,22,14,88
2023-03-07 16:19:59.555708,8,22,24,14,14,82
2023-03-07 16:20:00.583266,10,2,23,6,3,44
2023-03-07 16:20:01.611147,6,5,19,15,21,66
2023-03-07 16:20:02.635935,17,8,8,3,19,55
2023-03-07 16:20:03.659644,8,10,14,13,5,50
2023-03-07 16:20:04.687086,17,24,18,22,23,104
2023-03-07 16:20:05.714937,11,17,5,22,14,69
2023-03-07 16:20:06.747655,7,19,2,9,7,44
2023-03-07 16:20:07.771336,24,6,9,18,9,66
2023-03-07 16:20:08.795036,10,4,10,14,6,44
2023-03-07 16:20:09.818790,22,10,9,13,5,59
2023-03-07 16:20:10.842015,8,4,15,16,17,60
2023-03-07 16:20:11.867221,15,3,3,9,17,47
2023-03-07 16:20:12.891101,10,19,16,23,9,77
2023-03-07 16:20:13.918548,6,22,13,21,6,68
2023-03-07 16:20:14.942628,9,14,20,18,13,74
2023-03-07 16:20:15.966330,6,17,23,10,6,62
2023-03-07 16:20:16.989906,10,4,16,18,19,67
2023-03-07 16:20:18.015188,17,15,20,21,19,92
2023-03-07 16:20:19.042442,11,16,14,18,12,71
2023-03-07 16:20:20.070143,17,21,21,2,16,77
2023-03-07 16:20:21.097728,2,3,16,11,14,46
2023-03-07 16:20:22.121798,9,13,18,5,23,68
2023-03-07 16:20:23.150069,8,6,3,22,2,41
2023-03-07 16:20:24.174298,12,23,20,11,4,70
2023-03-07 16:20:25.201781,16,7,14,12,23,72
2023-03-07 16:20:26.229604,17,18,12,24,22,93
2023-03-07 16:20:27.258563,9,16,7,16,19,67
2023-03-07 16:20:28.286138,17,9,7,11,16,60
2023-03-07 16:20:29.313842,23,23,10,10,13,79
2023-03-07 16:20:30.341671,8,10,15,6,20,59
2023-03-07 16:20:31.365495,3,24,21,3,19,70
2023-03-07 16:20:32.390448,3,15,11,11,11,51
2023-03-07 16:20:33.417780,18,17,23,23,9,90
2023-03-07 16:20:34.441858,24,22,9,23,6,84
2023-03-07 16:20:35.465320,17,24,6,5,18,70
2023-03-07 16:20:36.488836,4,12,9,20,13,58
2023-03-07 16:20:37.513808,6,6,10,11,7,40
2023-03-07 16:20:38.537799,12,20,24,11,17,84
2023-03-07 16:20:39.565371,8,15,4,21,4,52
2023-03-07 16:20:40.589196,22,24,9,7,4,66
2023-03-07 16:20:41.613137,4,8,3,10,21,46
2023-03-07 16:20:42.636609,6,18,20,3,13,60
2023-03-07 16:20:43.661683,22,17,8,21,20,88
2023-03-07 16:20:44.689009,23,19,19,5,10,76
2023-03-07 16:20:45.713087,21,24,23,23,5,96
2023-03-07 16:20:46.740414,9,12,10,16,18,65
2023-03-07 16:20:47.764779,18,3,21,8,24,74
2023-03-07 16:20:48.787776,5,8,7,20,21,61
2023-03-07 16:20:49.812722,7,19,18,6,10,60
2023-03-07 16:20:50.836868,16,8,13,20,21,78
2023-03-07 16:20:51.864298,22,21,19,20,6,88
2023-03-07 16:20:52.892000,20,14,13,19,23,89
2023-03-07 16:20:53.923664,7,6,19,7,7,46
2023-03-07 16:20:54.948406,19,4,23,19,23,88
2023-03-07 16:20:55.976100,22,21,19,5,3,70
2023-03-07 16:20:57.000073,15,24,9,24,6,78
2023-03-07 16:20:58.028645,9,16,16,12,21,74
2023-03-07 16:20:59.056648,3,22,2,23,22,72
2023-03-07 16:21:00.084175,11,8,15,12,23,69
2023-03-07 16:21:01.111721,14,16,17,2,6,55
2023-03-07 16:21:02.135411,2,13,21,19,19,74
2023-03-07 16:21:03.160368,23,24,7,17,14,85
2023-03-07 16:21:04.188117,10,11,17,10,14,62
2023-03-07 16:21:05.216103,12,12,24,10,2,60
2023-03-07 16:21:06.239900,7,11,10,6,3,37
2023-03-07 16:21:07.263598,22,23,22,3,17,87
2023-03-07 16:21:08.287303,3,9,23,22,24,81
2023-03-07 16:21:09.312126,21,22,22,16,17,98
2023-03-07 16:21:10.339834,12,12,4,14,22,64
2023-03-07 16:21:11.371045,13,13,23,17,5,71
2023-03-07 16:21:12.396370,10,19,5,8,2,44
2023-03-07 16:21:13.420200,5,10,2,17,16,50
2023-03-07 16:21:14.447211,15,22,10,8,6,61
2023-03-07 16:21:15.474920,5,4,3,2,7,21
2023-03-07 16:21:16.504333,9,10,18,10,14,61
2023-03-07 16:21:17.531756,13,7,12,9,12,53
2023-03-07 16:21:18.559323,4,17,21,24,24,90
2023-03-07 16:21:19.587028,13,3,11,22,13,62
2023-03-07 16:21:20.614606,21,14,11,10,20,76
2023-03-07 16:21:21.647859,22,13,14,6,24,79
2023-03-07 16:21:22.675134,7,15,22,3,23,70
2023-03-07 16:21:23.698978,21,4,6,17,12,60
2023-03-07 16:21:24.724178,5,16,9,23,4,57
2023-03-07 16:21:25.747620,7,14,5,16,18,60
2023-03-07 16:21:26.778405,22,13,7,20,3,65
2023-03-07 16:21:27.802607,3,19,3,4,10,39
2023-03-07 16:21:28.827571,16,20,12,5,6,59
2023-03-07 16:21:29.855307,21,12,24,22,18,97
2023-03-07 16:21:30.883136,14,19,9,12,8,62
2023-03-07 16:21:31.911102,12,14,23,9,10,68
2023-03-07 16:21:32.939549,24,21,15,9,17,86
2023-03-07 16:21:33.967252,10,8,16,4,11,49
2023-03-07 16:21:34.991068,5,17,12,19,21,74
2023-03-07 16:21:36.018513,20,19,2,9,15,65
2023-03-07 16:21:37.042500,7,7,8,24,12,58
2023-03-07 16:21:38.067317,11,22,12,14,11,70
2023-03-07 16:21:39.099043,12,19,9,14,12,66
2023-03-07 16:21:40.126040,3,10,5,15,3,36
2023-03-07 16:21:41.149741,22,7,23,10,9,71
2023-03-07 16:21:42.175118,19,9,22,17,9,76
2023-03-07 16:21:43.198965,12,24,16,16,4,72
2023-03-07 16:21:44.230572,14,15,23,10,18,80
2023-03-07 16:21:45.259233,10,24,11,18,24,87
2023-03-07 16:21:46.286937,17,22,13,23,7,82
2023-03-07 16:21:47.314495,18,23,23,17,10,91
2023-03-07 16:21:48.342466,3,20,11,22,18,74
2023-03-07 16:21:49.369906,8,20,13,2,8,51
2023-03-07 16:21:50.395124,13,9,13,20,16,71
2023-03-07 16:21:51.422699,9,20,6,4,18,57
2023-03-07 16:21:52.446098,5,8,14,12,2,41
2023-03-07 16:21:53.469929,17,11,14,11,5,58
2023-03-07 16:21:54.500999,3,9,21,8,12,53
2023-03-07 16:21:55.526377,15,15,16,4,6,56
2023-03-07 16:21:56.550335,5,9,21,3,10,48
2023-03-07 16:21:57.574039,15,8,8,10,15,56
2023-03-07 16:21:58.597748,20,24,21,15,20,100
2023-03-07 16:21:59.629223,24,17,15,16,12,84
2023-03-07 16:22:00.657892,9,15,22,17,2,65
2023-03-07 16:22:01.681868,18,10,21,5,6,60
2023-03-07 16:22:02.705559,3,5,10,10,20,48
2023-03-07 16:22:03.729126,11,20,23,24,21,99
2023-03-07 16:22:04.761587,21,5,8,8,21,63
2023-03-07 16:22:05.785238,20,18,23,3,18,82
2023-03-07 16:22:06.812829,17,8,10,18,14,67
2023-03-07 16:22:07.842059,16,3,21,2,15,57
2023-03-07 16:22:08.869762,16,12,6,21,2,57
2023-03-07 16:22:09.893857,8,21,10,4,4,47
2023-03-07 16:22:10.917560,12,9,21,10,15,67
2023-03-07 16:22:11.950300,9,6,5,14,14,48
2023-03-07 16:22:12.973961,3,7,14,9,9,42
2023-03-07 16:22:13.997414,14,8,19,2,10,53
2023-03-07 16:22:15.021240,18,24,2,15,24,83
2023-03-07 16:22:16.048686,8,8,7,21,10,54
2023-03-07 16:22:17.077803,14,13,22,12,19,80
2023-03-07 16:22:18.104920,14,19,20,15,16,84
2023-03-07 16:22:19.132622,7,24,6,21,20,78
2023-03-07 16:22:20.156465,6,4,7,18,3,38
2023-03-07 16:22:21.181323,4,22,6,21,18,71
2023-03-07 16:22:22.209330,8,19,12,18,24,81
2023-03-07 16:22:23.236598,2,20,18,17,20,77
2023-03-07 16:22:24.264308,13,14,16,16,15,74
2023-03-07 16:22:25.293282,11,4,8,12,23,58
2023-03-07 16:22:26.320830,12,18,20,4,11,65
2023-03-07 16:22:27.353699,9,15,18,23,4,69
2023-03-07 16:22:28.381363,2,2,11,16,7,38
2023-03-07 16:22:29.405327,6,21,23,3,2,55
2023-03-07 16:22:30.428877,24,2,20,23,18,87
2023-03-07 16:22:31.456311,24,12,15,12,13,76
2023-03-07 16:22:32.490014,20,18,13,12,9,72
2023-03-07 16:22:33.517018,21,6,23,20,8,78
2023-03-07 16:22:34.540715,9,19,24,3,24,79
2023-03-07 16:22:35.564548,15,14,23,20,9,81
2023-03-07 16:22:36.591861,16,24,23,7,4,74
2023-03-07 16:22:37.620869,2,21,13,12,22,70
2023-03-07 16:22:38.648399,22,7,18,22,14,83
2023-03-07 16:22:39.676099,22,22,24,3,15,86
2023-03-07 16:22:40.704923,4,9,22,9,17,61
2023-03-07 16:22:41.729018,20,12,8,8,7,55
2023-03-07 16:22:42.756750,3,22,9,16,15,65
2023-03-07 16:22:43.779876,19,9,13,11,7,59
2023-03-07 16:22:44.804820,19,6,12,7,15,59
2023-03-07 16:22:45.832568,14,20,3,14,13,64
2023-03-07 16:22:46.860260,11,23,4,11,19,68
2023-03-07 16:22:47.892004,15,18,7,14,23,77
2023-03-07 16:22:48.916934,7,13,17,3,6,46
2023-03-07 16:22:49.940646,9,18,8,4,10,49
2023-03-07 16:22:50.964347,15,2,6,11,14,48
2023-03-07 16:22:51.987921,5,12,13,15,4,49
2023-03-07 16:22:53.015778,7,3,22,13,5,50
2023-03-07 16:22:54.040326,4,9,22,6,21,62
2023-03-07 16:22:55.064156,14,6,19,24,2,65
2023-03-07 16:22:56.087552,18,9,16,11,3,57
2023-03-07 16:22:57.110976,23,15,11,19,2,70
2023-03-07 16:22:58.139164,7,7,18,18,13,63
2023-03-07 16:22:59.164217,13,21,9,20,19,82
2023-03-07 16:23:00.191210,5,6,5,21,22,59
2023-03-07 16:23:01.215504,19,24,20,16,23,102
2023-03-07 16:23:02.243199,17,22,23,17,21,100
2023-03-07 16:23:03.270318,9,12,4,4,15,44
2023-03-07 16:23:04.296369,4,2,17,9,3,35
2023-03-07 16:23:05.319561,2,21,22,18,21,84
2023-03-07 16:23:06.343133,13,18,11,12,12,66
2023-03-07 16:23:07.370564,22,10,12,24,7,75
2023-03-07 16:23:08.405549,18,13,6,23,6,66
2023-03-07 16:23:09.430704,17,3,23,5,13,61
2023-03-07 16:23:10.454520,14,23,12,16,7,72
2023-03-07 16:23:11.483438,8,13,21,18,16,76
2023-03-07 16:23:12.511089,9,8,15,5,19,56
2023-03-07 16:23:13.539814,19,11,13,12,21,76
2023-03-07 16:23:14.567633,12,6,13,11,3,45
2023-03-07 16:23:15.591591,18,4,11,11,12,56
2023-03-07 16:23:16.618780,19,24,12,7,20,82
2023-03-07 16:23:17.642871,22,22,2,15,18,79
2023-03-07 16:23:18.676598,6,23,8,6,14,57
2023-03-07 16:23:19.699402,24,21,14,21,9,89
2023-03-07 16:23:20.726975,24,4,17,4,20,69
2023-03-07 16:23:21.750635,3,7,13,7,8,38
2023-03-07 16:23:22.773940,23,9,23,3,23,81
2023-03-07 16:23:23.801425,12,5,24,10,10,61
2023-03-07 16:23:24.830653,10,20,9,8,7,54
2023-03-07 16:23:25.854617,22,19,6,7,24,78
2023-03-07 16:23:26.881931,24,5,23,17,9,78
2023-03-07 16:23:27.906150,6,4,10,19,15,54
2023-03-07 16:23:29.068359,5,11,23,18,22,79
2023-03-07 16:23:30.097041,15,9,2,7,13,46
2023-03-07 16:23:31.120992,18,7,11,20,16,72
2023-03-07 16:23:32.149819,12,11,11,3,18,55
2023-03-07 16:23:33.177528,16,11,8,10,17,62
2023-03-07 16:23:34.202025,2,14,17,12,17,62
2023-03-07 16:23:35.228633,16,17,19,9,23,84
2023-03-07 16:23:36.252466,6,19,5,8,11,49
2023-03-07 16:23:37.276339,12,13,18,13,16,72
2023-03-07 16:23:38.305161,22,8,24,7,12,73
2023-03-07 16:23:39.329242,9,6,13,22,20,70
2023-03-07 16:23:40.352821,20,23,15,17,20,95
2023-03-07 16:23:41.380393,9,5,12,15,5,46
2023-03-07 16:23:42.404097,24,9,22,23,17,95
2023-03-07 16:23:43.429303,3,19,18,6,15,61
2023-03-07 16:23:44.453014,11,23,2,3,23,62
2023-03-07 16:23:45.476708,4,2,6,9,11,32
2023-03-07 16:23:46.500160,17,13,3,20,13,66
2023-03-07 16:23:47.523818,6,24,16,22,10,78
2023-03-07 16:23:48.547397,23,15,20,3,2,63
2023-03-07 16:23:49.571104,18,24,14,5,3,64
2023-03-07 16:23:50.596235,18,21,24,10,20,93
2023-03-07 16:23:51.623799,6,21,15,16,12,70
2023-03-07 16:23:52.651507,7,4,18,7,22,58
2023-03-07 16:23:53.675331,22,21,10,5,10,68
2023-03-07 16:23:54.704078,14,16,7,18,12,67
2023-03-07 16:23:55.731859,7,15,6,11,19,58
2023-03-07 16:23:56.755827,4,23,8,7,22,64
2023-03-07 16:23:57.779520,11,2,24,7,20,64
2023-03-07 16:23:58.806843,17,20,16,8,5,66
2023-03-07 16:23:59.832176,22,14,15,7,12,70
2023-03-07 16:24:00.859460,10,15,7,8,15,55
2023-03-07 16:24:01.887033,17,18,11,14,7,67
2023-03-07 16:24:02.915030,2,18,4,5,8,37
2023-03-07 16:24:03.938872,19,21,9,22,14,85
2023-03-07 16:24:04.967368,23,10,16,11,22,82
2023-03-07 16:24:05.995521,5,9,4,13,6,37
2023-03-07 16:24:07.019225,14,7,24,14,9,68
2023-03-07 16:24:08.042935,13,16,15,22,3,69
2023-03-07 16:24:09.070496,2,4,24,3,15,48
2023-03-07 16:24:10.096357,19,22,12,9,14,76
2023-03-07 16:24:11.122699,7,13,17,10,10,57
2023-03-07 16:24:12.150735,21,18,14,17,2,72
2023-03-07 16:24:13.174522,3,18,14,10,9,54
2023-03-07 16:24:14.202736,17,9,20,20,8,74
2023-03-07 16:24:15.230539,10,6,19,10,19,64
2023-03-07 16:24:16.258546,10,14,23,23,15,85
2023-03-07 16:24:17.286501,19,24,20,5,23,91
2023-03-07 16:24:18.315201,19,7,10,23,6,65
2023-03-07 16:24:19.343207,5,3,16,21,3,48
2023-03-07 16:24:20.366984,17,17,9,15,6,64
2023-03-07 16:24:21.394314,17,22,14,11,20,84
2023-03-07 16:24:22.422145,8,11,5,7,20,51
2023-03-07 16:24:23.447092,7,7,15,9,7,45
2023-03-07 16:24:24.470795,12,11,21,5,9,58
2023-03-07 16:24:25.498638,21,14,17,16,5,73
2023-03-07 16:24:26.525651,16,22,7,17,14,76
2023-03-07 16:24:27.550735,4,16,14,8,6,48
2023-03-07 16:24:28.574731,13,9,3,22,18,65
2023-03-07 16:24:29.598558,15,14,3,17,17,66
2023-03-07 16:24:30.629643,9,13,14,12,22,70
2023-03-07 16:24:31.653837,18,6,19,23,9,75
2023-03-07 16:24:32.678543,14,20,24,7,19,84
2023-03-07 16:24:33.705997,16,19,5,8,23,71
2023-03-07 16:24:34.730074,20,6,21,15,16,78
2023-03-07 16:24:35.761783,9,19,3,17,3,51
2023-03-07 16:24:36.786352,24,10,9,8,2,53
2023-03-07 16:24:37.810181,18,9,23,6,5,61
2023-03-07 16:24:38.833488,5,3,4,24,18,54
2023-03-07 16:24:39.857170,14,15,16,3,24,72
2023-03-07 16:24:40.888249,10,22,24,23,20,99
2023-03-07 16:24:41.917619,21,23,2,6,8,60
2023-03-07 16:24:42.941691,24,3,19,20,8,74
2023-03-07 16:24:43.969023,4,15,7,5,15,46
2023-03-07 16:24:44.992977,16,2,22,18,18,76
2023-03-07 16:24:46.026585,17,9,22,23,24,95
2023-03-07 16:24:47.053254,13,19,4,3,8,47
2023-03-07 16:24:48.076960,5,10,6,24,13,58
2023-03-07 16:24:49.100786,4,12,23,19,22,80
2023-03-07 16:24:50.125864,11,18,16,17,17,79
2023-03-07 16:24:51.153191,7,8,20,21,18,74
2023-03-07 16:24:52.177123,8,10,6,14,24,62
2023-03-07 16:24:53.200553,24,14,22,16,5,81
2023-03-07 16:24:54.228297,15,9,16,19,17,76
2023-03-07 16:24:55.253759,22,18,18,24,11,93
2023-03-07 16:24:56.281214,5,11,10,9,7,42
2023-03-07 16:24:57.308810,23,21,9,7,6,66
2023-03-07 16:24:58.332621,24,8,20,9,13,74
2023-03-07 16:24:59.357309,6,19,2,24,14,65
2023-03-07 16:25:00.385041,14,11,20,17,10,72
2023-03-07 16:25:01.413141,22,12,2,11,10,57
2023-03-07 16:25:02.440312,2,9,23,7,11,52
2023-03-07 16:25:03.464291,9,7,3,8,19,46
2023-03-07 16:25:04.488797,11,4,4,6,21,46
2023-03-07 16:25:05.512488,12,20,9,21,10,72
2023-03-07 16:25:06.540351,8,9,13,6,15,51
2023-03-07 16:25:07.569320,8,3,15,21,5,52
2023-03-07 16:25:08.596758,13,19,3,24,17,76
2023-03-07 16:25:09.624605,2,23,23,8,4,60
2023-03-07 16:25:10.648305,17,2,14,21,15,69
2023-03-07 16:25:11.675871,3,13,23,17,24,80
2023-03-07 16:25:12.699555,14,2,24,11,8,59
2023-03-07 16:25:13.724790,12,5,15,9,24,65
2023-03-07 16:25:14.748486,5,11,5,21,4,46
2023-03-07 16:25:15.772199,15,20,11,3,16,65
2023-03-07 16:25:16.799343,24,21,8,10,21,84
2023-03-07 16:25:17.823543,23,24,5,7,14,73
2023-03-07 16:25:18.847009,11,10,5,15,13,54
2023-03-07 16:25:19.872256,9,9,11,13,23,65
2023-03-07 16:25:20.895961,20,2,12,12,24,70
2023-03-07 16:25:21.923286,18,17,23,14,8,80
2023-03-07 16:25:22.950987,16,12,22,24,21,95
2023-03-07 16:25:23.978890,23,13,22,22,7,87
2023-03-07 16:25:25.004144,4,13,16,15,21,69
